,Date,City,State,Dead,Injured,Total,Description,Year
371,2021-12-31,Capitol Heights,Maryl,0,4,4,An adult and three juveniles were wounded in an evening shooting.,2021
372,2021-12-31,Los Angeles,California,0,6,6,Six shoppers were wounded at a grocery supermarket by two black male shooters.,2021
373,2021-12-31,Gulfport,Mississippi,4,3,7,"During an outdoor New Year's Eve party, a physical fight started escalated to a shooting, with multiple people firing guns.",2021
374,2021-12-30,Philadelphia,Pennsylvania,0,6,6,Six shooters opened fire on a busy street with six wounded.,2021
375,2021-12-30,Kirksville,Missouri,2,2,4,An adult and infant were killed and two adults wounded in an afternoon shooting.,2021
376,2021-12-27,Mobile,Alabama,1,3,4,A man was killed and three others wounded at a local gas station.,2021
377,2021-12-27,Youngstown,Ohio,1,3,4,A man was killed and three others were wounded at a local apartment complex.,2021
378,2021-12-27,Denver  and Lakewood,Colorado,6,2,8,A gunman went on a shooting spree across multiple locations in the Denver metropolitan area before dying in a shootout with police.,2021
379,2021-12-26,Garland,Texas,3,1,4,Three teenagers were killed and a fourth wounded in a convenience store.,2021
380,2021-12-26,Buffalo,New York,0,4,4,Four adults were wounded inside a pop-up store.,2021
381,2021-12-26,Clear Brook,Virginia,1,4,5,"Four people were wounded at a rest stop, and the shooter fled before police arrived. The shooter was later found dead.",2021
382,2021-12-26,Fayette,Mississippi,0,7,7,Seven people were wounded at a party in the early morning. An 18-year-old was later arrested.,2021
383,2021-12-26,Philadelphia,Pennsylvania,0,4,4,Four people were wounded in a drive by shooting in North Philadelphia.,2021
384,2021-12-25,Lafayette,Louisiana,0,4,4,Four people were wounded near a Waffle House in the early morning.,2021
385,2021-12-24,New York City,New York,0,4,4,Four men were wounded outside a Brooklyn deli shortly before midnight.,2021
386,2021-12-24,Roswell,Georgia,1,3,4,A woman was arrested after killing one and wounding three in a domestic incident at an apartment.,2021
387,2021-12-24,Swissvale,Pennsylvania,0,6,6,"Six people were found wounded in a local home, with one identified as the potential shooter.",2021
388,2021-12-19,Brooklyn,Illinois,1,3,4,One man was killed and three others were wounded in a shooting across the street from a strip club.,2021
389,2021-12-17,Baltimore,Maryl,1,4,5,A man was killed and four people wounded in Penn North.,2021
390,2021-12-17,Portsmouth,Virginia,0,4,4,Four adults were wounded in the early morning at a gentleman's club.,2021
391,2021-12-17,Baltimore,Maryl,1,3,4,One person was killed and three wounded in Upton.,2021
392,2021-12-16,Troy,Alabama,0,4,4,Four people were wounded in an afternoon shooting.,2021
393,2021-12-13,Fresno,California,0,4,4,Police were alerted to four wounded by gunfire after an argument escalated through a shotspotter alert.,2021
394,2021-12-13,Philadelphia,Pennsylvania,0,4,4,"Four adults were wounded in Kengsington, they were found by patrolling police.",2021
395,2021-12-13,Durham,North Carolina,2,4,6,"Six people in an SUV were shot at in the early morning, causing the SUV to crash. Two adults were killed and four juveniles wounded.",2021
396,2021-12-12,Baytown,Texas,1,14,15,One person was killed and fourteen others wounded in a drive-by shooting at a memorial vigil in Baytown for another shooting victim.,2021
397,2021-12-12,Woodbridge,Virginia,0,4,4,Three security guards and a bystander were shot by a gunman at a nightclub.,2021
398,2021-12-12,Bolton,Mississippi,0,6,6,Six people were wounded at local sports bar in the early morning.,2021
399,2021-12-12,Tampa,Florida,0,5,5,"Five people were wounded in the early morning, a suspect was arrested days later.",2021
400,2021-12-11,River Grove,Illinois,1,3,4,"Four adults were shot at a bowling alley at approximately 1 AM, killing a 23-year-old man.",2021
401,2021-12-10,Lansing,Michigan,1,3,4,"Three teenagers and a baby were shot while in a car near an intersection, killing a 17-year-old girl.",2021
402,2021-12-10,Orlando,Florida,0,5,5,Five people were shot in a drive-by shooting in the Callahan neighborhood.,2021
403,2021-12-10,Charlotte,North Carolina,0,5,5,Five people were shot in the Grier Heights neighborhood.,2021
404,2021-12-09,Beloit,Wisconsin,1,5,6,"Responding officers found one person killed and two wounded, with an additional two wounded found at the hospital.",2021
405,2021-12-06,Philadelphia,Pennsylvania,0,4,4,Three men and a teenager were wounded in Brewerytown.,2021
406,2021-12-05,El Paso,Texas,1,3,4,"A fight broke out in the parking lot of a bar, after a group was ejected. It escalated, with bystanders attempting to intervene. A man walked up and shot at the bystanders killing one and wounding three.",2021
407,2021-12-05,Detroit,Michigan,2,2,4,"Four men were shot by a gunman, two of whom succumbed to their injuries.",2021
408,2021-12-03,Memphis,Tennessee,2,2,4,Two teenagers were killed and a teenager and an infant were wounded in a drive-by shooting at a gas station.,2021
409,2021-12-02,Elizabeth City,North Carolina,3,3,6,Responding officers found two adults and a child killed and three adults wounded.,2021
410,2021-11-30,Rex,Georgia,4,2,6,Responding officers to a domestic incident were shot at by the suspect. The suspect had killed two women and wounded a child previously. An officer and the suspect were killed and another officer was wounded.,2021
411,2021-11-30,Oxford,Michigan,4,7,11,"Oxford High School shooting: A 15-year-old student opened fire at Oxford High School initially killing three students and wounding seven others and a teacher, before being arrested. One of the wounded died a day later. The suspect was charged with four counts of murder and seven counts of attempted murder while his parents, who bought him the gun used in the shooting as an early Christmas present, were charged with four counts of involuntary manslaughter.",2021
412,2021-11-28,Philadelphia,Pennsylvania,0,4,4,Four people were wounded in an evening shooting in Kingsessing.,2021
413,2021-11-28,Lancaster,California,5,0,5,A man killed his four children and his mother in law in their home. He turned himself in to police an hour later and was charged with five counts of murder.,2021
414,2021-11-28,Aurora,Colorado,0,5,5,Five youths were wounded in a shooting.,2021
415,2021-11-28,Baltimore,Maryl,0,7,7,Responding police found six adults and a teenager wounded in East Baltimore.,2021
416,2021-11-28,Evanston,Illinois,1,4,5,A teenager was killed and four others wounded at a gas station.,2021
417,2021-11-27,Newark,New Jersey,1,3,4,A teenager was killed and three others were wounded after men in a car opened fire in the South Ward.,2021
418,2021-11-26,Nashville,Tennessee,3,4,7,"Home invaders killed two teenagers and wounded their mother, two teenage siblings and an adult sibling. One of the assailants was also killed.",2021
419,2021-11-25,San Antonio,Texas,2,2,4,Two men were killed and two others wounded in a believed targeted drive-by shooting. Eyewitnesses are not cooperating with police.,2021
420,2021-11-25,Green Sea,South Carolina,0,4,4,Four people were wounded and transported to the hospital in private vehicles.,2021
421,2021-11-23,Lehigh Acres,Florida,0,4,4,Four people were wounded after a large party was ending. Police believe it connected to another incident near a local hospital.,2021
422,2021-11-23,Marshall,Texas,1,3,4,A man was killed and three others wounded shortly before noon. A suspect was arrested.,2021
423,2021-11-22,Warsaw,North Carolina,2,2,4,Two men were killed and two juveniles were wounded while in a vehicle outside an apartment complex.,2021
424,2021-11-21,Baton Rouge,Louisiana,1,4,5,A man was killed and four others were wounded in the parking lots of a local club.,2021
425,2021-11-21,Passaic,New Jersey,0,5,5,Four adults and one child were shot during a backyard party.,2021
426,2021-11-20,Berwyn,Illinois,0,4,4,Four people were wounded at a local bar in the early morning.,2021
427,2021-11-20,Fresno,California,2,2,4,Two men were killed and two wounded at an apartment complex.,2021
428,2021-11-18,Cambridge,Maryl,1,3,4,"One teen was killed, and three other teens were wounded in two separate but related shootings on the same block.",2021
429,2021-11-17,Chicago,Illinois,0,4,4,Four people were wounded in a drive-by shooting shortly after midnight on the Near West Side.,2021
430,2021-11-17,East St. Louis,Illinois,1,3,4,A man was killed and three others wounded in an afternoon shooting.,2021
431,2021-11-17,New York City,New York,0,4,4,Two adults and two teens were wounded in a potentially targeted drive-by in Williamsbridge.,2021
432,2021-11-17,Newburgh,New York,0,4,4,Four teens were shot during a gunfight near a high school.,2021
433,2021-11-15,Aurora,Colorado,0,6,6,Six teenagers were wounded in a drive-by shooting at a park located across from a high school.,2021
434,2021-11-15,New York City,New York,0,4,4,Four men were shot outside of a bodega in Harlem.,2021
435,2021-11-14,Chiloquin,Oregon,2,2,4,"Four people were shot, two of the victims fatally. A man from Klamath Falls was arrested and charged with murder.",2021
436,2021-11-14,Tucson,Arizona,4,1,5,"Four men arrived at a trailer park and confronted a homeowner and a guest, leading to the homeowner shooting and killing the four men and the guest being injured by the four attackers.",2021
437,2021-11-14,Troy,Alabama,1,5,6,A man was killed and five others wounded at a gas station in the early morning.,2021
438,2021-11-14,Columbia,Missouri,1,5,6,"Two men opened fire at each other at a lounge, wounding five. One of the shooters was killed by responding police.",2021
439,2021-11-14,Philadelphia,Pennsylvania,0,6,6,"Three men and three women were shot, one man critically.",2021
440,2021-11-13,Houma,Louisiana,0,4,4,"Four people were wounded at a high school homecoming after-party, after multiple attendees began shooting.",2021
441,2021-11-13,Winston-Salem,North Carolina,0,4,4,Four people were wounded after several people opened fire at a party.,2021
442,2021-11-12,Richmond,Virginia,2,2,4,Two children were killed and two adults wounded on the East End.,2021
443,2021-11-12,Birmingham,Alabama,2,2,4,"Two wounded were found outside a vehicle, where two were found deceased in the backseat. Several weapons were found in the vehicle.",2021
444,2021-11-09,Rochester,New York,0,4,4,Four teenagers were wounded in an evening shooting.,2021
445,2021-11-09,Scotland,South Dakota,3,2,5,Three adults were killed and an adult and child were wounded after an argument escalated inside a home.,2021
446,2021-11-09,Killona,Louisiana,1,4,5,A man was killed and three adults and a teenager wounded in an ambush-style shooting outside a grocery store.,2021
447,2021-11-08,Philadelphia,Pennsylvania,0,4,4,Three teenagers and an adult were wounded after three of them exited a local store in Feltonville and were chased down the street.,2021
448,2021-11-07,Kenosha,Wisconsin,1,3,4,A man was killed and three others wounded in the early morning.,2021
449,2021-11-06,Oakley,California,2,2,4,Two people were killed and two wounded at a family birthday party.,2021
450,2021-11-06,Marshall,Texas,0,6,6,Six people were wounded in the early morning at a large community event.,2021
451,2021-11-06,Highland,California,0,4,4,"Shortly after midnight a man opened fire at a local bar, wounding four.",2021
452,2021-11-05,Oakland,California,1,3,4,A man was killed and three wounded in a drive-by shooting in East Oakland.,2021
453,2021-11-03,Norfolk,Virginia,3,2,5,A man killed three women and wounded two in a targeted domestic dispute. One of the wounded was targeted and the others attempted to help her.,2021
454,2021-11-03,Des Moines,Iowa,0,4,4,Four people were wounded in an evening shooting a block away from a middle school.,2021
455,2021-11-02,Mobile,Alabama,0,4,4,A woman shot and wounded four in a bowling alley after a fight escalated.,2021
456,2021-11-01,Orlando,Florida,0,4,4,"After an online dispute, a person shot four people in Downtown Orlando.",2021
457,2021-11-01,San Antonio,Texas,0,4,4,Four people were wounded in an evening drive-by on the West Side.,2021
458,2021-10-31,Louisville,Kentucky,2,2,4,Two cousins working as security were shot and killed. Two others were wounded.,2021
459,2021-10-31,Flossmoor,Illinois,1,3,4,Four people were shot just after midnight on Halloween.,2021
460,2021-10-31,Lakewood,Colorado,2,2,4,"Four people were shot, two fatally.",2021
461,2021-10-31,Houston,Texas,1,9,10,A woman was shot and killed and nine injured at a large Halloween party of hundred people.,2021
462,2021-10-31,Joliet,Illinois,2,12,14,Two people were killed and several wounded after two men opened fire on a Halloween party.,2021
463,2021-10-31,Fort Worth,Texas,1,3,4,An 18-year-old was arrested after killing a man and wounding three others in a drive-by shooting.,2021
464,2021-10-30,Sacramento,California,2,5,7,Two people were killed and five injured at a Halloween party that was held at a local banquet hall.,2021
465,2021-10-30,Decatur,Illinois,0,4,4,Four people were wounded at a large house party in the early morning.,2021
466,2021-10-30,Texarkana,Texas,1,9,10,A man was killed and several people wounded after a shooting at a Halloween party.,2021
467,2021-10-30,Oklahoma City,Oklahoma,0,4,4,Four people were wounded in a residential area in the early morning.,2021
468,2021-10-30,St. Petersburg,Florida,1,4,5,A man was killed and four others wounded at an outdoor boxing match at the Skyway Plaza.,2021
469,2021-10-30,Gilroy,California,1,3,4,One person was killed and three wounded after a shooting at a house party. The party occurred at the home of a Gilroy councilwoman.,2021
470,2021-10-29,Kalamazoo,Michigan,0,4,4,Four people were shot at a party inside an event center.,2021
471,2021-10-29,Poughkeepsie,New York,0,5,5,Three people were wounded at a birthday party and two more were wounded as the tour bus transporting some of the wounded was later shot at.,2021
472,2021-10-28,Las Vegas,Nevada,0,4,4,Four people were wounded after an argument in an alley escalated.,2021
473,2021-10-28,Nashville,Tennessee,1,3,4,A man was killed and three wounded in a suspected robbery shortly before midnight.,2021
474,2021-10-25,Boise,Idaho,3,4,7,"Two people, including a security guard, were shot and killed at a mall, and four others were wounded. The shooter was injured by responding officers and died the next day after being taken into custody.",2021
475,2021-10-25,Memphis,Tennessee,0,4,4,Three teenagers and an adult were wounded after a shooting near an elementary school.,2021
476,2021-10-24,Gonzales,California,2,2,4,"Two people were killed, and two others injured at an off-roading event.",2021
477,2021-10-24,Crenshaw,Mississippi,2,3,5,Two people were killed and three injured in a shooting on Jones Street.,2021
478,2021-10-23,Fort Valley,Georgia,1,7,8,A man was killed and seven others wounded at an off-campus party about two blocks from Fort Valley State University.,2021
479,2021-10-23,Florence,South Carolina,0,6,6,Six people were wounded in an early morning shooting at a local bar.,2021
480,2021-10-23,Ontario,California,1,4,5,A teenager was killed and one adult and three juveniles wounded at a Halloween party.,2021
481,2021-10-22,Renton,Washington,0,4,4,Four people were wounded in the parking lot of a banquet hall that was hosting a Halloween party.,2021
482,2021-10-22,Baltimore,Maryl,0,7,7,Five adults and two teenagers were wounded in a drive-by shooting.,2021
483,2021-10-22,Chicago,Illinois,0,5,5,Five people were wounded outside a Chatham liqueur store when a man opened fire and then fled.,2021
484,2021-10-21,New York City,New York,0,4,4,A gunman exited a subway station and shot four people in the Flatbush section of Brooklyn.,2021
485,2021-10-21,Tacoma,Washington,4,0,4,Three adults were killed and a fourth later died at the hospital in a night time shooting.,2021
486,2021-10-20,Farwell,Michigan,4,0,4,"A woman shot and killed her father, sister and two workers at their home in the afternoon.",2021
487,2021-10-19,Kenosha,Wisconsin,3,2,5,"A man killed his roommate's teenage daughter and her boyfriend, and wounded his roommate and her 14-year-old son. He later killed himself.",2021
488,2021-10-17,Grambling,Louisiana,1,7,8,A person was killed and seven others wounded at Grambling State University during a homecoming event in the early morning.,2021
489,2021-10-17,Houston,Texas,0,5,5,Responding officers found an SUV in a ditch with bullet holes and blood near Winzer Park. Four adults and a juvenile were later identified at local hospitals although none had reached out to police.,2021
490,2021-10-17,Jackson,Mississippi,3,3,6,Three people were killed and three injured after a man opened fire inside a night club.,2021
491,2021-10-17,Pine Bluff,Arkansas,1,7,8,"Gunfire erupted at a party hall wounding eleven and killing one, responding police opened fire on a man holding a gun and wounded him.",2021
492,2021-10-17,Racine,Wisconsin,0,6,6,Six people were wounded at a one-year anniversary vigil for a man killed in the location. Neighbors refused to cooperate with police due to fear of retaliation.,2021
493,2021-10-17,Colorado Springs,Colorado,0,5,5,Five people were wounded outside a local bar after an unknown number of people opened fire.,2021
494,2021-10-17,Pine Bluff,Arkansas,0,4,4,Responding officers found four people wounded and shell casings around a car in the intersection.,2021
495,2021-10-17,St. Louis,Missouri,1,3,4,A 19-year-old was killed and three teenagers were wounded in the early morning in the Baden neighborhood.,2021
496,2021-10-16,Killeen,Texas,1,3,4,Four people were wounded in the parking lot of a club in the early morning. One of the wounded died two days later.,2021
497,2021-10-15,Mobile,Alabama,0,5,5,Five people were wounded at a high school football game.,2021
498,2021-10-14,Minneapolis,Minnesota,1,4,5,Responding police found five people wounded in Ventura Village. One of the wounded later died at the hospital.,2021
499,2021-10-12,Meridian,Mississippi,3,1,4,Three adults were killed in a home and an infant was found wounded.,2021
500,2021-10-12,Naples,Florida,1,5,6,A man was killed and three others wounded after two shooters opened fire on a Naples Park home. The shooters were also wounded.,2021
501,2021-10-11,South Fulton,Georgia,0,6,6,"Three wounded were found by responding officers, a fourth flagged down officers and two others were found at local hospitals.",2021
502,2021-10-10,Dover,Delaware,1,4,5,A man was killed and four others wounded after a drive-by shooting at a house party in the early morning.,2021
503,2021-10-10,Chicago,Illinois,1,4,5,A man was killed and four others injured in an early morning drive-by outside a Wicker Park nightclub.,2021
504,2021-10-10,Sioux City,Iowa,0,4,4,Four bystanders were wounded at an after hours club in an early morning targeted shooting.,2021
505,2021-10-10,McColl,South Carolina,2,3,5,Two people were killed and three injured in a shooting near a nightclub.,2021
506,2021-10-10,Saint Paul,Minnesota,1,14,15,One person was killed and 14 injured in a shootout at a bar.,2021
507,2021-10-09,Dallas,Texas,0,4,4,Three 18-year-olds and a 16-year-old were wounded in South Dallas.,2021
508,2021-10-09,Denver,Colorado,1,3,4,Responding officers found one man killed and three wounded.,2021
509,2021-10-09,Livingston,Louisiana,2,4,6,Two people were killed and three others wounded after a man went on a multi-parish shooting spree. He was later arrested with a self-inflicted gunshot wound and a dog bite.,2021
510,2021-10-09,Albany,New York,1,6,7,Responding officers found one man deceased and six wounded were later found in local hospitals.,2021
511,2021-10-08,Baltimore,Maryl,0,4,4,Four men were wounded in Southeast Baltimore in the afternoon.,2021
512,2021-10-08,Washington D.C.,Washington D.C.,1,3,4,"Responding police discovered a deceased man and another wounded, with two more identified at local hospitals.",2021
513,2021-10-07,Chicago,Illinois,0,4,4,Two teenagers and two adults were wounded in the early morning after someone opened fire on another car on the Near North Side.,2021
514,2021-10-07,Milwaukee,Wisconsin,0,5,5,Five people were wounded when a police officer opened fire on an armed suspect who returned fire before he fled the area.,2021
515,2021-10-07,Milwaukee,Wisconsin,3,1,4,Three adults were killed and another wounded after two men came back thirty minutes after an argument over parking and opened fire.,2021
516,2021-10-06,Cleveland,Ohio,0,4,4,Four adults were wounded at a music studio shortly before midnight.,2021
517,2021-10-06,Baltimore,Maryl,1,5,6,A woman was killed and five people were wounded in East Baltimore.,2021
518,2021-10-06,New Orleans,Louisiana,1,3,4,A man was killed and three others wounded after four people exited a vehicle and opened fire on them. The victims were doing work in a parking lot behind a church.,2021
519,2021-10-05,Rockford,Illinois,1,3,4,Responding police found four injured due to an evening shooting and one later died at the hospital.,2021
520,2021-10-05,Saint Paul,Minnesota,0,4,4,A teen shot four people inside a vehicle at an intersection.,2021
521,2021-10-04,Minneapolis,Minnesota,0,4,4,Three men and a juvenile were wounded at a local gas station.,2021
522,2021-10-03,Bishopville,South Carolina,1,4,5,A man was killed and four others wounded in an early morning drive by shooting at a Waffle House.,2021
523,2021-10-02,Aurora,Colorado,1,3,4,"A man was killed and two adults and a teenager were wounded at an early morning hotel party,",2021
524,2021-10-02,San Antonio,Texas,1,3,4,A man was killed and two adults and a teenager wounded at an apartment complex.,2021
525,2021-10-01,Washington D.C.,Washington D.C.,1,5,6,Five adults were wounded and one killed in Southwest D.C. late at night.,2021
526,2021-10-01,Cedar Rapids,Iowa,0,6,6,Five adults and a teenager were wounded after an argument at a hotel birthday party celebration escalated.,2021
527,2021-09-29,Chicago,Illinois,0,5,5,Five bystanders were wounded when passengers of two separate cars opened fire on one another while driving down a Fulton River District road.,2021
528,2021-09-28,Minneapolis,Minnesota,1,3,4,A man was fatally shot and three others injured in a gunfire incident on Bloomington Avenue in the Phillips neighborhood.,2021
529,2021-09-28,Chicago,Illinois,1,3,4,A woman was killed and three others injured in the early morning after a man opened fire on a car in Park Manor.,2021
530,2021-09-27,Chicago,Illinois,1,3,4,A man was killed and two adults and a teenager wounded in Humboldt Park on the Northwest Side.,2021
531,2021-09-27,New York City,New York,0,5,5,A man opened fire outside a club in Inwood in Upper Manhattan wounding four. Responding officers opened fire and wounded him.,2021
532,2021-09-26,Des Moines,Washington,3,3,6,Two groups of people began fighting in a bar and others joined in as it spilled into the parking lot. Some fighters got into cars and opened fire while driving away killing three and wounding three others.,2021
533,2021-09-26,Chicago,Illinois,0,6,6,Six adults were wounded in East Garfield Park on the West Side in the early morning.,2021
534,2021-09-26,Oakland,California,0,4,4,Four people including a teenager were wounded in East Oakland.,2021
535,2021-09-25,Athens,Tennessee,4,0,4,Two adults arrived at a home and engaged in an argument with the four adults there over a 10-month old. The dispute escalated and the four adults living at the home were killed and the two suspects kidnapped the child.,2021
536,2021-09-25,Riverside,California,0,6,6,Shortly after midnight six people were wounded at a large house party.,2021
537,2021-09-25,Chattanooga,Tennessee,2,5,7,Responding police found two adults killed and four adults and a child wounded.,2021
538,2021-09-25,Utica,New York,0,4,4,Four men were wounded in the early morning.,2021
539,2021-09-24,Los Angeles,California,0,4,4,Four people were wounded at the Rosa Parks Metro Station in Willowbrook.,2021
540,2021-09-24,Aiken,South Carolina,4,1,5,A man murdered his parents and sister and wounded another sibling before committing suicide.,2021
541,2021-09-23,Collierville,Tennessee,2,14,16,"Collierville Kroger shooting: A worker at a third-party venue inside the store opened fire in a Kroger, killing one and injuring 14, before taking his own life.",2021
542,2021-09-23,Philadelphia,Pennsylvania,0,4,4,Four men were wounded in the Mantua neighborhood.,2021
543,2021-09-22,Fayetteville,North Carolina,2,2,4,Two teenagers were killed and two others injured in a home invasion. Three days earlier a relative of the two deceased had been killed in another home.,2021
544,2021-09-21,Washington D.C.,Washington D.C.,0,5,5,"A man opened fire and wounded four adults and one child near Alabama Avenue, Southeast.",2021
545,2021-09-20,St. Louis,Missouri,1,3,4,"A man was killed and three others wounded while at a vigil for another homicide victim, when a group of people opened fire from a black SUV.",2021
546,2021-09-20,El Monte,California,1,4,5,"A man was killed and four others wounded, with the deceased found behind the wheel of a vehicle.",2021
547,2021-09-20,Philadelphia,Pennsylvania,1,5,6,A man was killed and five others injured in a drive-by shooting in the Fern Rock neighborhood.,2021
548,2021-09-19,Miami,Florida,0,4,4,"During an argument one of the victims pulled out her gun and pointed it at the ground, after things calmed down she put it away and began to enter a car with her husband, and two children. The man she was arguing with opened fire once they got to the car, wounding her, her husband and two children.",2021
549,2021-09-19,Dallas,Texas,2,4,6,Two adults were killed and three others and a teenager wounded shortly after midnight when a man opened fire.,2021
550,2021-09-19,Oakland,California,1,3,4,A man was killed and three others wounded in the early morning while outside a club.,2021
551,2021-09-19,Chicago,Illinois,0,5,5,"Five people were wounded while sitting on a porch in Austin during the early morning, after two men exited a vehicle and opened fire.",2021
552,2021-09-19,Rochester,New York,2,2,4,"Two people were killed and two injured after someone shot down an alley at a group standing outside, who were attending a party. The shooting occurred on the anniversary of a similar mass shooting in 2020.",2021
553,2021-09-19,Yemassee,South Carolina,1,7,7,After an argument escalated someone opened fire shortly after midnight killing one adult and wounding one adult and seven children.,2021
554,2021-09-18,Opelousas,Louisiana,0,5,5,Five family members were injured after a gunman opened fire on their mobile home at night.,2021
555,2021-09-18,Danville,Illinois,2,2,4,Two people were killed and two wounded at a liquor store in the early morning.,2021
556,2021-09-18,New York City,New York,1,3,4,"A man was killed and three others wounded at a BBQ at Claremont Park in the Bronx, after an argument escalated.",2021
557,2021-09-18,New York City,New York,0,4,4,Four people were shot outside a club in the East Flatbush area of Brooklyn after a dispute.,2021
558,2021-09-17,Augusta,Georgia,0,4,4,Four people were wounded in the early morning at a night club. Two men were later arrested.,2021
559,2021-09-14,Baltimore,Maryl,0,4,4,Three teenagers and a boy were injured in a shooting.,2021
560,2021-09-14,Cleveland,Ohio,0,6,6,Six people were wounded after an incident at a liquor store escalated.,2021
561,2021-09-13,Milwaukee,Wisconsin,0,5,5,Five people were wounded in a shooting at a candlelight vigil near the intersection in Sherman Park. The vigil was held for a 16-year-old who was killed at the same intersection earlier that day.,2021
562,2021-09-12,Saint Paul,Minnesota,4,0,4,"An SUV with four deceased adults was found in a local cornfield in Wheeler, Wisconsin. It was discovered later that the four victims were shot in Saint Paul following an argument at a bar with the shooter. The perpetrator's father followed his son in a vehicle on the way to Wheeler and then gave his son a ride home after his son abandoned the SUV in the cornfield.",2021
563,2021-09-12,Temple,Texas,0,4,4,Four people were found wounded from a shooting.,2021
564,2021-09-12,Detroit,Michigan,2,4,6,Two women were killed and four others wounded in a drive-by shooting that targeted a family birthday party.,2021
565,2021-09-12,Blue Island,Illinois,2,2,4,"Three people were found wounded on the street by police, and a fourth victim was located after he fled to the hospital. Two of the victims perished at the hospital.",2021
566,2021-09-11,Chicago,Illinois,1,5,6,A woman was killed and four adults and a teenager wounded in a West Pullman drive-by while walking as a group.,2021
567,2021-09-11,Dothan,Alabama,0,5,5,Five teenagers were wounded at a party at a local shopping center.,2021
568,2021-09-11,Utica,New York,0,4,4,Responding officers found four men wounded.,2021
569,2021-09-11,Paterson,New Jersey,0,4,4,Responding officers discovered two wounded from an early morning shooting. Two others arrived were identified at the hospital.,2021
570,2021-09-11,Chicago,Illinois,1,3,4,A man was killed and three others injured in South Side drive-by shooting.,2021
571,2021-09-10,Orlando,Florida,0,4,4,"Deputies were called after a man got drunk and fired shots into the air. He then opened fire on the security guard and officers, before driving down the road, getting into a car accident and opening fire on those in the car. He wounded the security guards and three in the vehicle.",2021
572,2021-09-09,East St. Louis,Illinois,0,7,7,Six adults and a child were wounded in a drive-by shooting. The suspects attempted to flee the area but were hit by a MetroLink train.,2021
573,2021-09-09,Montgomery,Alabama,1,3,4,Responding officers found one child deceased and two adults and another child injured.,2021
574,2021-09-08,St. Louis,Missouri,0,4,4,Four people were wounded after two men got into an argument after one was seen arguing and pistol whipping a woman.,2021
575,2021-09-07,Wilmington,Delaware,0,4,4,Four people were wounded in a local park in the Southbridge neighborhood after a drive-by shooting.,2021
576,2021-09-07,Wichita,Kansas,1,5,6,"After getting kicked out of a night club shortly after midnight, a man opened fire killed a man and wounded five women.",2021
577,2021-09-06,Atlanta,Georgia,0,5,5,"A man opened fire after an argument at a local Black Pride festival, wounding five.",2021
578,2021-09-05,Houston,Texas,4,0,4,Firefighters discovered a husband and wife and two children deceased when responding to a house fire. Family members believe the family had been dead for days before the fire.,2021
579,2021-09-05,Cincinnati,Ohio,0,4,4,"Three adults and a teenager were wounded after an argument outside a Mt. Washington home. The victims went inside, before the suspect fired through the door.",2021
580,2021-09-05,Lakeland,Florida,4,2,6,"A former Marine sharpshooter shot and killed three adults, an infant, and a dog and wounded a child inside and outside a home, before engaging in a shootout with police. The shooter was eventually injured in the gunfight and then apprehended.",2021
581,2021-09-05,Athens,Georgia,0,7,7,A man fired into a crowd of people that were fighting in the early morning. He wounded seven and turned himself in the next day.,2021
582,2021-09-05,Detroit,Michigan,0,4,4,Four men were injured in a shooting outside a rollerskating rink on Eight Mile Road in the west side.,2021
583,2021-09-05,Wyatt,Missouri,0,4,4,Four adults were wounded at a family car show after two men opened fire on the crowd in suspected gang violence.,2021
584,2021-09-05,New York City,New York,0,4,4,Four adults were wounded outside a catering hall in the Bronx after an argument escalated.,2021
585,2021-09-05,Independence,Missouri,0,4,4,An adult and three teenagers were wounded at a local festival after two people got into an argument and one opened fire.,2021
586,2021-09-04,Monroe,Louisiana,1,3,4,"Responding officers found four people injured, with one later dying at the hospital.",2021
587,2021-09-04,Washington D.C.,Washington D.C.,3,3,6,"Six people were found injured in Northwest DC, with three later dying at a hospital.",2021
588,2021-09-04,Birmingham,Alabama,2,2,4,Two people were killed and two injured after an argument inside a strip mall store escalated. Three people were arrested and one went on the run.,2021
589,2021-09-04,Pittsburgh,Pennsylvania,0,4,4,A teenager shot four people on the street in Homewood South.,2021
590,2021-09-04,Chicago,Illinois,0,5,5,Five people were injured in a drive-by shooting in Lawndale shortly after midnight.,2021
591,2021-09-04,Warner Robins,Georgia,1,4,5,A teenager was killed and four others injured while attending a block party.,2021
592,2021-09-03,Syracuse,New York,0,4,4,Four adults were wounded in an early morning shooting during an outdoor party.,2021
593,2021-09-03,New Iberia,Louisiana,1,3,4,"One person was killed and three injured outside a shoe store in a strip mall, after two men exited a car and opened fire.",2021
594,2021-09-03,Austin,Texas,1,3,4,A woman was killed and three others injured in an apartment complex close to US Highway 290 in East Austin.,2021
595,2021-09-02,Niagara Falls,New York,0,4,4,Four people were wounded after shooters opened fire on them across the street while they were standing outside a deli.,2021
596,2021-08-31,Elm City,North Carolina,2,2,4,A man killed one person and wounded two others before kidnapping a woman and infant. He later killed the woman and left the baby alive in the stolen vehicle and is still on the run.,2021
597,2021-08-30,Normal,Illinois,3,3,6,"A man killed two people and wounded three others in a mobile home park, before being killed by responding police.",2021
598,2021-08-29,Las Vegas,Nevada,1,3,4,Three adults were wounded and one was killed near Rainbow Boulevard.,2021
599,2021-08-29,Nashville,Tennessee,0,5,5,Five people were wounded in an early morning drive by shooting on Jefferson Street.,2021
600,2021-08-29,Milwaukee,Wisconsin,0,4,4,An adult and three teenagers were wounded.,2021
601,2021-08-28,San Diego,California,0,4,4,"Two groups got into an argument near Belmont Park and a man opened fire, wounding four people.",2021
602,2021-08-28,Chicago,Illinois,0,4,4,Four adults were wounded in Douglas Park while attending a large gathering.,2021
603,2021-08-28,Albany,New York,0,5,5,"Responding officers found two wounded men, a wounded teenager and two other adults were later found at hospitals.",2021
604,2021-08-27,Sharon Hill,Pennsylvania,1,4,5,"After a football game at a high school, a civilian was injured in a drive-by shooting. Police fired back, which district attorney Jack Stollsteimer says likely hit four people, including an eight-year-old girl who was killed.",2021
605,2021-08-27,Huntington,West Virginia,2,2,4,"Two adults and two children were shot, with an adult and child later dying from their injuries.",2021
606,2021-08-27,Los Angeles,California,0,4,4,Four men were found injured in the West Hollywood neighborhood.,2021
607,2021-08-26,Minneapolis,Minnesota,0,7,7,Seven people were wounded just after midnight when two people opened fire at one another.,2021
608,2021-08-23,Chicago,Illinois,0,4,4,A teenager and three adults were wounded in a drive by shooting in Uptown.,2021
609,2021-08-22,Portland,Oregon,0,5,5,Five men were wounded at a vigil for a man that had been killed in the same location earlier in the day.,2021
610,2021-08-22,Grand Rapids,Michigan,1,3,4,One person was killed and three wounded in an early morning shooting.,2021
611,2021-08-22,Carbondale,Illinois,1,3,4,A SIU student was killed and three other people wounded at a party hosted at a private residence.,2021
612,2021-08-22,Chicago,Illinois,1,4,5,"A man was killed and three adults and a teenager were wounded in East Garfield Park, about four hours after a previous mass shooting.",2021
613,2021-08-21,Chicago,Illinois,0,4,4,Four people were wounded in an East Garfield Park drive-by.,2021
614,2021-08-21,Chicago,Illinois,1,5,6,"A man was killed and five others wounded while standing in a Calumet Heights parking lot, after two men opened fire from an alley.",2021
615,2021-08-20,Flint,Michigan,1,3,4,One person died and three were injured after a shooting.,2021
616,2021-08-19,Edgewood,Maryl,1,3,4,A man was killed and three others wounded in an evening shooting.,2021
617,2021-08-19,Philadelphia,Pennsylvania,1,4,5,A drive-by shooting outside a barbershop killed one and wounded four.,2021
618,2021-08-19,Chicago,Illinois,0,4,4,Four people were shot in a Bronzeville business.,2021
619,2021-08-18,Germantown,Maryl,1,3,4,"A teenager was arrested for allegedly shooting four people on a basketball court, killing a man and wounding three teenagers.",2021
620,2021-08-18,Youngstown,Ohio,2,4,6,"Two people, including a 10-year-old girl, were killed, and four wounded after a shooting.",2021
621,2021-08-18,Los Angeles,California,0,4,4,Four men were wounded after a shooting in Playa del Ray.,2021
622,2021-08-18,Durham,North Carolina,1,3,4,A man was killed and three injured in a shooting.,2021
623,2021-08-17,New York City,New York,0,5,5,Five men were wounded in a drive-by shooting outside a grocery store in Brooklyn.,2021
624,2021-08-16,New York City,New York,0,8,8,Five women and three men were wounded outside a housing project in Brooklyn shortly after midnight.,2021
625,2021-08-16,Detroit,Michigan,1,3,4,A man was killed and three others injured outside a local bar.,2021
626,2021-08-15,San Antonio,Texas,3,2,5,"Three people were killed and two injured after a fight escalated in the parking lot of a local sports bar on the East Side, by a man who drew a long gun and shot into the air.",2021
627,2021-08-15,Chicago,Illinois,0,4,4,Three men and a woman were wounded standing outside a home shortly after midnight.,2021
628,2021-08-14,Indianapolis,Indiana,1,4,5,A man was killed and three adults and a child wounded in a strip mall parking lot in the early morning.,2021
629,2021-08-14,Trenton,New Jersey,0,4,4,Responding officers found four wounded in the early morning.,2021
630,2021-08-14,Akron,Ohio,0,5,5,Four adults and a teenager were wounded outside a nightclub shortly after midnight.,2021
631,2021-08-14,New York City,New York,0,4,4,Four men were wounded in Brooklyn shortly after midnight.,2021
632,2021-08-13,Las Vegas,Nevada,1,6,7,One person was killed and six teenagers wounded after a fight broke out at a local park shortly after midnight.,2021
633,2021-08-11,Philadelphia,Pennsylvania,1,4,5,A man opened fire on a group playing a dice game outside a local bar. One man was killed and four injured.,2021
634,2021-08-10,Clarksdale,Mississippi,2,2,4,A woman and teenager were killed and two other individuals wounded in an evening shooting.,2021
635,2021-08-10,Portland,Oregon,2,4,6,"Two men, identified as rap-artists connected to the Wu-Tang Clan, were killed and four others wounded, in a potential drive-by shooting.",2021
636,2021-08-09,Flint,Michigan,2,4,6,Two teenagers were killed and four others injured at a late-night party at a city park.,2021
637,2021-08-09,Boston,Massachusetts,1,5,6,"A woman was killed and five others were injured in a shooting on Irma Street near the Mattapan/Dorchester border. Police arrived at the scene at about 12:30 a.m. and pronounced the woman dead. On August 24, police charged a 37-year-old man with murder in connection to the shooting.",2021
638,2021-08-08,Houston,Texas,1,5,6,A man was killed and five others wounded after a fight in a night club escalated out of the club and into the parking lot.,2021
639,2021-08-08,Chicago,Illinois,1,6,7,"Two men were arguing outside a lounge on the South Side, before it escalated. One of the two was killed, and the other along with five bystanders was injured.",2021
640,2021-08-08,New York City,New York,2,3,5,Two men were killed and three wounded at an outdoor event space in Brooklyn shortly after midnight.,2021
641,2021-08-08,New Orleans,Louisiana,0,5,5,Five people were shot in the early morning on Bourbon Street. This was the second weekend in a row with a mass shooting in the city.,2021
642,2021-08-08,Chicago,Illinois,1,4,5,A security guard and four others were wounded after a man got into an argument with two security guards outside a club on the South Side.,2021
643,2021-08-07,Montgomery,Alabama,0,4,4,Three men and a woman were wounded shortly after midnight.,2021
644,2021-08-07,Chicago,Illinois,0,4,4,Four men were wounded in a drive-by shooting.,2021
645,2021-08-07,Norfolk,Virginia,0,4,4,Four people were wounded in an early morning shooting in the Neon District.,2021
646,2021-08-06,Nashville,Tennessee,0,4,4,"Four people, two on the side walk and two in a vehicle, were wounded in a drive-by shooting in West Nashville.",2021
647,2021-08-04,Philadelphia,Pennsylvania,0,4,4,Four adults were wounded a block away from Temple University Hospital.,2021
648,2021-08-03,Urbana,Illinois,1,3,4,A woman was killed and three others injured in the early morning in a home. Three men walked to the side of the home and shot repeatedly through the windows and walls.,2021
649,2021-08-02,Greenwood,South Carolina,3,1,4,Two adults and a child were killed and a child wounded in a home. The shooter was arrested in Florida shortly after.,2021
650,2021-08-02,Columbia,South Carolina,0,9,9,Nine people were wounded in the early morning at a local dance studio.,2021
651,2021-08-01,New Orleans,Louisiana,1,3,4,A teenager was killed and two teenagers and an adult were wounded by a teenager in the Central Business District. He was turned in by a family member.,2021
652,2021-08-01,Providence,Rhode Isl,0,5,5,Five people were wounded in the parking lot of a Popeyes restaurant in the early morning.,2021
653,2021-08-01,Nacogdoches,Texas,1,3,4,A man was killed and three wounded in an early morning shooting. Five suspects were later arrested.,2021
654,2021-08-01,New Orleans,Louisiana,0,5,5,Five adults were wounded in an early morning shooting near Bourbon Street.,2021
655,2021-07-31,Lexington,Kentucky,0,5,5,Responding officers found five people wounded in an evening shooting.,2021
656,2021-07-31,Indianapolis,Indiana,0,5,5,Three adults and two children were wounded outside a funeral home. It is believed an argument escalated inside the building prior.,2021
657,2021-07-31,New York City,New York,0,10,10,"Ten people, including seven bystanders, were wounded in a night-time gang shooting outside a laundromat. The incident took place in North Corona, Queens.",2021
658,2021-07-31,Saginaw,Michigan,2,2,4,Two people were wounded and two killed at a large public gathering.,2021
659,2021-07-31,Chicago,Illinois,0,4,4,Four adults were wounded in an early morning shooting while at a gathering in Jackson Park on the South Side.,2021
660,2021-07-31,Columbus,Ohio,1,4,5,"Five people were wounded in an early morning shooting outside a local bar, and one died later at the hospital. An argument escalated causing a gunfight between multiple people.",2021
661,2021-07-29,Davenport,Iowa,0,4,4,A feud between the occupants of two vehicles escalated into gunfire injuring three adults and a child.,2021
662,2021-07-29,Pittsburgh,Pennsylvania,3,2,5,"After an argument a man shot and killed his parents. He called 911, and stated he wished to turn himself in, but opened fire at responding officers wounding two. He fled the scene in a vehicle that he crashed and was discovered dead due to a self inflicted gunshot wound.",2021
663,2021-07-28,Washington D.C.,Washington D.C.,0,4,4,Four adults were wounded in a shooting in Southeast DC.,2021
664,2021-07-28,Charleston,South Carolina,1,4,5,"Five people were wounded in an afternoon shooting, with one later dying at the hospital.",2021
665,2021-07-26,Fort Worth,Texas,2,3,5,"A shooter killed one and injured three after opening fire at a backyard party, after becoming upset, leaving and returning. He was chased down by partygoers who threw bricks at him in defense, and was pronounced dead by responding police.",2021
666,2021-07-25,Seattle,Washington,2,3,5,Two people were killed and three injured after someone opened fire on a group leaving a nightclub.,2021
667,2021-07-25,Chicago,Illinois,0,5,5,"Five men were wounded shortly after midnight while standing in an Austin backyard, after a man entered and opened fire.",2021
668,2021-07-25,Wasco,California,5,1,6,"When responding to a hostage situation at a home in Wasco, officers were fired upon by the shooter. Two officers were shot, and one succumbed to their injuries. Three people inside the house were slain by the shooter. The gunman was also killed during the shootout.",2021
669,2021-07-25,Detroit,Michigan,0,7,7,Seven people were wounded at a candlelit vigil on the West Side for a hit and run victim. The shooter pulled up in a vehicle and opened fire on the crowd.,2021
670,2021-07-24,Amarillo,Texas,0,6,6,Six people were wounded in an early morning shooting after an argument escalated at an after-hours club.,2021
671,2021-07-24,Macon,Georgia,2,2,4,Two people were killed and two injured shortly after midnight after a fight escalated.,2021
672,2021-07-24,Columbus,Ohio,0,4,4,Four people were wounded in a parking lot in Short North in an early morning.,2021
673,2021-07-23,Darlington,South Carolina,0,4,4,Four people were wounded in a van after individuals in a pickup truck opened fire in the early morning.,2021
674,2021-07-23,Spartanburg,South Carolina,2,2,4,Two people were killed and two wounded in a drive-by-shooting.,2021
675,2021-07-23,San Rafael,California,2,4,6,"Two people were killed and four injured inside a parking garage near a local nightclub. Responding officers attempted to stop multiple vehicles leaving the structure, with some carrying shooting victims.",2021
676,2021-07-22,Houston,Texas,1,5,6,One person was killed and five injured outside a local restaurant in a drive-by shooting.,2021
677,2021-07-21,Chicago,Illinois,0,8,8,"Shortly before midnight someone opened fire on a party bus passing by a gas station in Old Town. Seven people were wounded in the bus, and one while pumping gas.",2021
678,2021-07-21,Chicago,Illinois,2,3,5,A 15-year-old and a 16-year-old were killed and three other adults were wounded on a street corner. The 16-year-old died the next day.,2021
679,2021-07-21,Adelphi,Maryl,1,4,5,A man was killed and four others wounded at a condo complex after an argument escalated.,2021
680,2021-07-21,Chicago,Illinois,2,3,5,"Ten minutes after an earlier shooting, three teenagers  and two adults were wounded in North Lawndale.",2021
681,2021-07-20,Jacksonville,Texas,4,0,4,Four adults were killed in a robbery after three men broke into their home. The three men were arrested later the next day.,2021
682,2021-07-19,Chicago,Illinois,0,4,4,Four men were injured in Homan Square while standing outside at night.,2021
683,2021-07-19,Perth Amboy,New Jersey,0,6,6,A gunman opened fire at a group of people leaving a bar early in the morning. Six people were wounded.,2021
684,2021-07-18,Burlington,North Carolina,0,4,4,Four were wounded in a shooting after an argument.,2021
685,2021-07-18,Toledo,Ohio,1,3,4,One person was killed and three wounded in a shooting.,2021
686,2021-07-18,Gainesville,Florida,1,4,5,A man was killed and four others wounded in a drive by shooting outside of a convenience store.,2021
687,2021-07-18,Houston,Texas,3,2,5,Responding officers arrived at a motel where a man was threatening to kill others and responding officers. The man shot and killed two adults and wounded two others before being shot and killed by police.,2021
688,2021-07-18,Walnut Creek,California,1,3,4,One person died and three were wounded after a shooting outside a nightclub.,2021
689,2021-07-18,Tucson,Arizona,2,4,6,"Two EMTs were injured after a man opened fire on them as they responded to an unrelated medical incident. The man then drove to a nearby structure fire and shot at nearby people, killing a bystander and wounding a firefighter.",2021
690,2021-07-17,Chicago,Illinois,0,6,6,Five teenage girls aged 12 to 19 years old were wounded while standing outside a party in Austin on the West Side.,2021
691,2021-07-17,Portland,Oregon,1,6,7,A woman was killed and six others were injured in a shooting in Downtown Portland.,2021
692,2021-07-16,Greenville,South Carolina,1,3,4,One person was killed and three injured at Conestee Park after an argument escalated.,2021
693,2021-07-16,Philadelphia,Pennsylvania,1,4,5,An adult was killed and three adults and a fourteen-year-old injured in an evening shooting.,2021
694,2021-07-16,Chicago,Illinois,1,3,4,One man was killed and three others injured in Austin shortly before midnight.,2021
695,2021-07-16,Manchester,New Hampshire,0,4,4,Four people were wounded as passengers in a van taking them from a nightclub.,2021
696,2021-07-16,Washington D.C.,Washington D.C.,1,5,6,A six-year-old girl was killed and five adults were injured in a shooting in the nation's capital.,2021
697,2021-07-16,Sacramento,California,2,4,6,Shortly before midnight two men were killed and four others injured in Old Sacramento near the old train tracks.,2021
698,2021-07-15,Levelland,Texas,1,3,4,Officers responding to a 911 call were fired upon by a suspect who barricaded themselves in a home. One officer was killed and three injured.,2021
699,2021-07-15,Lake Ozark,Missouri,1,4,5,A man was killed and four others injured after an argument and physical fight between multiple motorcycle clubs escalated.,2021
700,2021-07-15,Boston,Massachusetts,0,4,4,Officers responding to a ShotSpotter alert discovered four people wounded at the Bromley Heath Projects in Mission Hill.,2021
701,2021-07-14,Chicago,Illinois,0,5,5,Five adults were wounded outside a food mart in Gresham after three men jumped out of a car and opened fire.,2021
702,2021-07-14,Chicago,Illinois,0,5,5,"Five people were wounded in West Garfield Park on the West Side, after a man approached them and opened fire.",2021
703,2021-07-14,Claymont,Delaware,2,2,4,A man and teenager were killed and two adults wounded in an evening shooting in the Knollwood neighborhood.,2021
704,2021-07-13,Indianapolis,Indiana,0,4,4,"Four men were wounded in an early morning shooting, three of the four were found in a vehicle.",2021
705,2021-07-13,Detroit,Michigan,1,6,7,"A man was killed and six others wounded at a banquet hall, after a shooter opened fire due to an earlier argument. Attendees fired back and wounded the suspect, who was later arrested.",2021
706,2021-07-12,Iselin,New Jersey,0,4,4,Four people were wounded in the early morning at a hotel.,2021
707,2021-07-12,New York City,New York,0,4,4,Multiple masked shooters wounded four in Queens after exiting a car and opening fire.,2021
708,2021-07-12,Beaver Falls,Pennsylvania,2,3,5,Two men were killed and three injured after a gun fight between two cars in the parking lot of a housing complex.,2021
709,2021-07-12,Castroville,California,3,1,4,Three men were killed and one injured after a gunman opened fire at a house party.,2021
710,2021-07-11,El Paso,Texas,1,5,6,A man was killed and five others wounded at an activities complex in the early morning.,2021
711,2021-07-10,Philadelphia,Pennsylvania,0,6,6,Six men were wounded after two shooters walked up to them and opened fire shortly before midnight in the North Philadelphia neighborhood of Hunting Park.,2021
712,2021-07-10,Springfield,Ohio,1,3,4,A man was killed and a woman and two children were injured at a gas station in a potential incident of domestic violence.,2021
713,2021-07-10,Boston,Massachusetts,0,4,4,"Four people were wounded in Dorchester, neighbors at first believed it was continuing Independence Day celebrations.",2021
714,2021-07-08,Hartford,Connecticut,0,4,4,Four men were wounded by five teenagers who opened fire at the same location they had wounded a woman two days prior. The teenagers were later arrested.,2021
715,2021-07-05,Santa Rosa,California,1,3,4,A drive-by shooting left one person dead and three others injured at an illegal fireworks show.,2021
716,2021-07-05,Toledo,Ohio,1,11,12,One person was killed and eleven others injured at an Independence Day block party.,2021
717,2021-07-05,Buffalo,New York,0,4,4,Three adults and a three-year-old were injured while standing outside in a large group after someone opened fire.,2021
718,2021-07-05,Chicago,Illinois,2,4,6,"A shooting in Washington Park left two dead and four injured, including a 12-year-old girl and a 13-year-old boy.",2021
719,2021-07-04,Cleveland,Ohio,0,4,4,Four adults were wounded in an evening shooting.,2021
720,2021-07-04,Dallas,Texas,0,5,5,A shooting at an Independence Day gathering in southeast Dallas left at least four people wounded.,2021
721,2021-07-04,Kansas City,Missouri,0,4,4,"Four adults were wounded at a local club, and all refused to talk with law enforcement about the incident.",2021
722,2021-07-04,Dallas,Texas,3,2,5,A shooting at a neighborhood block party left three people dead and two injured.,2021
723,2021-07-04,Fort Worth,Texas,0,8,8,Eight people were wounded near a local car wash in the early morning.,2021
724,2021-07-04,Thermal,California,0,4,4,"An overnight shooting left four injured, two critically.",2021
725,2021-07-04,Danville,Illinois,0,4,4,Four people were wounded in a shooting at a rap concert.,2021
726,2021-07-04,Rantoul,Illinois,0,5,5,Two juveniles and three adults were wounded in a shooting.,2021
727,2021-07-04,Cincinnati,Ohio,2,3,5,Two people were killed and three injured in a shooting at a large teen party at a city park.,2021
728,2021-07-04,Omaha,Nebraska,1,4,5,"A group of people were fired upon in a parking lot, leaving one dead and four injured.",2021
729,2021-07-04,Peoria,Illinois,0,4,4,Two juveniles and two others were injured on Sunday night.,2021
730,2021-07-03,Chadbourn,North Carolina,3,1,4,Responding officers found three men killed and one injured at a large party in the early morning.,2021
731,2021-07-03,Lancaster,Pennsylvania,0,4,4,Four adults were wounded in an early morning shooting.,2021
732,2021-07-03,Swainsboro,Georgia,1,3,4,One person was killed and three injured in a shooting at a sports bar.,2021
733,2021-07-03,Chicago,Illinois,0,4,4,Shortly before midnight four men were wounded in a drive-by shooting in Gresham.,2021
734,2021-07-02,Norfolk,Virginia,0,4,4,Three teenagers and a six-year-old were injured in an afternoon shooting. A fifteen-year-old was later arrested in connection with the shooting.,2021
735,2021-07-02,Champaign,Illinois,1,4,5,"A teenager was killed and four adults, including a pregnant woman were injured at an American Legion after a funeral.",2021
736,2021-07-02,Philadelphia,Pennsylvania,1,4,5,A man was killed and four others injured after an afternoon shooting in East Mount Airy.,2021
737,2021-07-01,Chicago,Illinois,0,7,7,"Unknown assailants fired into a residence in Englewood, injuring seven people including a baby girl.",2021
738,2021-07-01,Spartanburg,South Carolina,2,4,6,"Two people, including the believed shooter, were killed and four injured in a shooting at a local park.",2021
739,2021-07-01,Chesapeake,Virginia,1,3,4,"Responding police officers to shots fired, found one man deceased and an adult and two teenagers injured.",2021
740,2021-06-30,Dover,Delaware,1,3,4,"A group of people were fired upon, leaving one killed and three injured.",2021
741,2021-06-30,Houston,Texas,3,1,4,Two adults and a six-year-old were killed and a ten-year-old injured in an evening shooting.,2021
742,2021-06-30,Chicago,Illinois,0,4,4,Four teenagers were wounded while walking in Little Village on the West Side in the evening.,2021
743,2021-06-30,Marrero,Louisiana,0,4,4,"A car pulled up to another car waiting to turn and opened fire. An adult, ten-month-old, four and fifteen-year olds were all injured.",2021
744,2021-06-28,Rochester,New York,1,3,4,"A man opened fire into a crowded Walmart parking lot, killing one and injuring three.",2021
745,2021-06-27,Chicago,Illinois,1,5,6,Five adults and a teenager were wounded in a drive-by shooting while standing outside in South Shore. A woman died later at the hospital,2021
746,2021-06-27,Memphis,Tennessee,3,1,4,A tenant with a mental disorder killed three and wounded a neighbor in his boarding house.,2021
747,2021-06-27,Greensboro,North Carolina,0,4,4,"After an argument escalated at a pool party hosted at an apartment complex, four people were wounded.",2021
748,2021-06-27,Chicago,Illinois,1,10,11,A woman died and ten others were injured after three shooters approached them from an alley and opened fire in Marquette Park.,2021
749,2021-06-27,St. Charles,Illinois,1,3,4,A man was killed and three others wounded at a night club in the early morning.,2021
750,2021-06-26,Fort Deposit,Alabama,1,3,4,An argument escalated at a funeral service after an outside group refused to turn down music in their car. A man was killed and three others injured.,2021
751,2021-06-26,Chicago,Illinois,1,3,4,A man was killed and three others wounded after an argument escalated in the morning in West Rogers Park.,2021
752,2021-06-26,Houston,Texas,1,3,4,A man was killed and three wounded at a pay-per-view event at a nightclub after a fight broke out.,2021
753,2021-06-25,Columbus,Ohio,0,4,4,Two children and two adults were shot in an SUV.,2021
754,2021-06-25,Chicago,Illinois,0,4,4,"Shortly before midnight, two men and two women were injured in a drive-by shooting in Park Manor, in which the shooter drove a moped.",2021
755,2021-06-25,New York City,New York,0,5,5,Five people were shot in an early morning drive-by at a graduation party in the Bronx.,2021
756,2021-06-24,Gainesville,Florida,1,4,5,"Two shooters opened fire at a local American Legion Post, which was hosting a teen party. All five injured were teenagers.",2021
757,2021-06-23,Montgomery,Alabama,2,2,4,Two men were found dead and two more injured by responding police officers.,2021
758,2021-06-23,Chicago,Illinois,0,4,4,Four motorcycle club members were wounded in Englewood.,2021
759,2021-06-23,Buffalo,New York,0,4,4,"Two adults and two children were wounded at the local JFK Park, after a man opened fire.",2021
760,2021-06-23,Chicago,Illinois,0,4,4,Four people were shot while standing outside when two shooters opened fire in South Austin.,2021
761,2021-06-21,Washington D.C.,Washington D.C.,0,4,4,Minnesota Vikings defensive tackle Jaylen Twyman was shot along with three others while visiting his aunt.,2021
762,2021-06-21,St. Louis,Missouri,3,4,7,Three people were killed and four injured in a shooting outside a convenience store.,2021
763,2021-06-20,Richmond,California,3,5,8,"Celebrators of a Marimba; a Guatemalan music and dance party, were shot by multiple shooters who fled in vehicles",2021
764,2021-06-20,Granger,Indiana,1,4,5,A man was killed and four others were wounded in an early morning shooting at a local brewing companies parking lot.,2021
765,2021-06-20,Dallas,Texas,0,8,8,"Eight people were wounded in a shootout between two groups after an argument escalated. Each group had rented a party space, and two of the injured were children.",2021
766,2021-06-20,Atlantic City,New Jersey,1,3,4,One man was killed and three others injured while standing on a porch after a bicyclist opened fire.,2021
767,2021-06-20,Wildwood,Florida,1,10,11,A woman was killed and ten others injured at an annual community Fathers Day celebration. The shooter was shortly arrested.,2021
768,2021-06-20,Cincinnati,Ohio,1,3,4,A woman was killed and three others injured shortly after midnight.,2021
769,2021-06-20,Aurora,Colorado,1,4,5,A man was killed and four others wounded during an early morning Juneteenth celebration at a local strip mall.,2021
770,2021-06-20,Richmond,Virginia,1,3,4,A man was killed and three wounded while leaving Shockoe Bottom after someone opened fire on a group of people.,2021
771,2021-06-19,Anchorage,Alaska,1,4,5,Four people wounded and one killed in a shooting.,2021
772,2021-06-19,Oakland,California,1,6,7,A man was killed and five others injured at Lake Merritt near the city's Juneteenth celebration.,2021
773,2021-06-19,Baton Rouge,Louisiana,2,4,6,Two people were killed and four injured in a parking lot after an argument escalated between unknown people and partygoers leaving a concert.,2021
774,2021-06-19,Newark,New Jersey,0,4,4,Responding officers found two wounded men in an early morning shooting. Shortly after two more were identified at a local hospital.,2021
775,2021-06-18,Minneapolis,Minnesota,0,5,5,Shortly before midnight five people were wounded in Dinkytown.,2021
776,2021-06-17,Durham,North Carolina,2,2,4,A shooting killed two and wounded another two.,2021
777,2021-06-17,Petersburg,Virginia,0,4,4,Four men were wounded in a shooting.,2021
778,2021-06-17,Paterson,New Jersey,0,4,4,Four people were wounded in a shooting.,2021
779,2021-06-17,Glendale,Peoria,1,12,13,"One person was killed and twelve others injured in eight drive-by shootings in the West Valley area. A male suspect was taken into custody. Of the injuries, three were wounded by gunfire, while nine others sustained indirect injuries, such as shrapnel from broken glass due to a car crash.",2021
780,2021-06-16,Baltimore,Maryl,1,5,6,"Six people were shot, one fatally, in West Baltimore.",2021
781,2021-06-15,Chicago,Illinois,0,5,5,Five people were wounded at West Garfield Park.,2021
782,2021-06-15,Chicago,Illinois,5,3,8,Four women were killed and three others injured after gunfire erupted in a South Side residence. Another woman died in a hospital.,2021
783,2021-06-15,Albertville,Alabama,2,2,4,A shooting at a Mueller Water Products factory killed two and injured two others.,2021
784,2021-06-14,Lansing,Michigan,2,2,4,Two people were killed and two others injured at a city park.,2021
785,2021-06-14,Boynton Beach,Florida,1,3,4,A drive-by shooting on Interstate 95 killed one and injured three.,2021
786,2021-06-13,Louisville,Kentucky,1,3,4,One man was killed and three other people were injured after a shooting in a Newburg neighborhood.,2021
787,2021-06-13,West Salem,Ohio,1,5,6,An altercation resulted in a shooting that killed one and injured five others at a racetrack.,2021
788,2021-06-12,Cleveland,Ohio,3,4,7,Three men were killed while three women and another man were injured in the Kinsman neighborhood.,2021
789,2021-06-12,Austin,Texas,1,13,14,"At least 14 people were shot in Downtown Austin in the early morning hours, leaving one dead. A suspect has been arrested while police are still looking for another.",2021
790,2021-06-12,Chicago,Illinois,1,9,10,A shooting in Chatham on the South Side left one dead and nine injured.,2021
791,2021-06-12,Cincinnati,Ohio,0,4,4,Four people were wounded in a drive-by. Two of the victims were children caught in crossfire.,2021
792,2021-06-11,Savannah,Georgia,1,7,8,One person was killed and seven others wounded in a shooting at a housing project.,2021
793,2021-06-11,Dallas,Texas,0,5,5,"A shooting left five people injured, including a four-year-old girl.",2021
794,2021-06-11,Winston-Salem,North Carolina,1,3,4,A shooting left one man dead and four others injured.,2021
795,2021-06-11,White Center,Washington,2,2,4,Two people were killed and two others hurt in a shooting in White Center near West Seattle.,2021
796,2021-06-10,Detroit,Michigan,1,3,4,"A drive by shooting on the west side left one dead and three injured, including a six-year-old boy.",2021
797,2021-06-10,Yonkers,New York,0,4,4,Four people were wounded in a drive by shooting that was potential gang activity.,2021
798,2021-06-08,Memphis,Tennessee,1,4,5,Four people were wounded and one killed in an afternoon shooting. The suspect is known to the victims.,2021
799,2021-06-08,Nashville,Tennessee,1,3,4,Three teenagers were wounded and an adult woman was killed after their cars were boxed in by other vehicles and fired upon. A fourth teenager was injured in a car accident as one of the cars attempted to flee the gunfire.,2021
800,2021-06-08,Houston,Texas,0,5,5,"Four people were shot, and a fifth wounded by bullet fragments in the early morning at a bar. The shooting was believed to be in retaliation of three men being denied entry into the bar.",2021
801,2021-06-07,Homestead,Florida,3,3,6,"A man killed his girlfriend, and another man, and injured three teenagers in a Florida home. The man committed suicide upon police arrival.",2021
802,2021-06-07,Cleveland,Ohio,0,6,6,Six people were wounded in an early morning shooting while standing on a porch.,2021
803,2021-06-06,Salt Lake City,Utah,1,4,5,One person was killed and four more injured in a drive-by shooting.,2021
804,2021-06-06,Portland,Oregon,4,0,4,Four people were shot dead at a home in southeast Portland.,2021
805,2021-06-06,Chicago,Illinois,0,8,8,"Two shooters opened fire on a group in Chatham, injuring eight.",2021
806,2021-06-06,Oakland,California,0,5,5,Five men were wounded in the Fremont neighborhood in a drive-by shooting.,2021
807,2021-06-06,St. Louis,Missouri,0,4,4,"Three shooters opened fire on a group of teenagers near Kiener Plaza, injuring four.",2021
808,2021-06-06,Maury,North Carolina,0,4,4,Four people were injured by gunfire at a party in a trailer park.,2021
809,2021-06-06,Kendall,Florida,3,6,9,Three people were killed and six more injured at a graduation party inside of a restaurant/hookah lounge.,2021
810,2021-06-05,New Orleans,Louisiana,0,8,8,Eight people were wounded in an evening shooting while standing outside a vacant hotel.,2021
811,2021-06-05,Indianapolis,Indiana,2,2,4,Two people were killed and two more injured while exiting a Boston Market earlier in the morning in northeastern Indianapolis.,2021
812,2021-06-04,Fruitport Township,Michigan,1,3,4,One person was killed and three injured.,2021
813,2021-06-02,Magnolia,Arkansas,0,4,4,Police responding to a fight at a local park were then notified of gunfire. Four people were wounded and one of the shooters was arrested after a car chase.,2021
814,2021-06-02,Springfield,Ohio,0,6,6,Two people are in custody after six people were injured in an overnight shooting at a wake.,2021
815,2021-06-02,Wilmington,Delaware,1,3,4,"A shooter opened fire on officers during a domestic dispute in an apartment, injuring three. The shooter was found dead from a self-inflicted gunshot wound the next day.",2021
816,2021-06-02,Toledo,Ohio,0,4,4,Four people were shot and one other was seriously injured after being run over by a car outside a bar.,2021
817,2021-05-31,New York City,New York,0,5,5,Five people were shot in the Bushwick area of Brooklyn.,2021
818,2021-05-31,St. Louis,Missouri,0,4,4,Four men were wounded in a drive-by shooting.,2021
819,2021-05-31,Garfield Heights,Ohio,1,4,5,"One person was killed and four others, including two teenagers, were injured in a shooting during a block party.",2021
820,2021-05-30,Chicago,Illinois,0,4,4,Four teens injured in drive-by.,2021
821,2021-05-30,Aliceville,Alabama,1,4,5,One person was killed and four others were injured at a residence.,2021
822,2021-05-30,Hialeah,Florida,3,20,23,"2021 Hialeah shooting: Three shooters stepped out of a white SUV, using assault rifles and handguns, and opened fire on a billiards club. Some of the gunmen are still at large.",2021
823,2021-05-29,San Antonio,Texas,2,2,4,"Two people were killed and two others injured in a drive-by shooting, after leaving a memorial service at a North Side bar.",2021
824,2021-05-28,Dellwood,Missouri,1,3,4,A man was killed and three other people injured shortly before midnight outside a club.,2021
825,2021-05-28,Miami,Florida,1,6,7,"Shortly before midnight, police responded to a ShotSpotter alert in Wynwood where they found one person killed and six injured.",2021
826,2021-05-27,Durham,North Carolina,0,5,5,A drive-by shooting left five people injured.,2021
827,2021-05-26,Chicago,Illinois,0,4,4,Three teenagers and an adult were wounded in an apartment in the Englewood neighborhood on the South Side. One of the teenagers was pronounced dead before being resuscitated by doctors.,2021
828,2021-05-26,San Jose,California,10,0,10,"2021 San Jose shooting: An employee opened fire at a Santa Clara Valley Transportation Authority  control center in San Jose, California, killing nine others before committing suicide.",2021
829,2021-05-24,Bay Shore,New York,0,4,4,Four people were wounded at a basketball court near a local marina when someone opened fire.,2021
830,2021-05-24,Inkster,Michigan,2,2,4,Two people were killed and two others were injured in a shooting while playing basketball.,2021
831,2021-05-24,West Jefferson,Ohio,4,0,4,At least four people were killed at an apartment complex.,2021
832,2021-05-23,Chicago,Illinois,0,4,4,Four men were wounded outside a home in East Garfield Park after a man opened fire in the afternoon.,2021
833,2021-05-23,Paterson,New Jersey,0,5,5,A shooting at large gathering left five people injured.,2021
834,2021-05-23,Norfolk,Virginia,0,4,4,Four people were wounded in an overnight shooting.,2021
835,2021-05-23,Youngstown,Ohio,3,8,11,Three people were killed and eight injured at a local bar in the early morning.,2021
836,2021-05-23,Park Forest,Illinois,0,4,4,An overnight shooting at a private party left four people injured.,2021
837,2021-05-22,Minneapolis,Minnesota,2,8,10,"The incident happened in the early morning near a downtown nightclub, after two men opened fire on each other during an argument.",2021
838,2021-05-22,San Angelo,Texas,0,4,4,Four people were injured after a shooting at a sports complex.,2021
839,2021-05-22,Columbus,Ohio,1,5,6,A 16-year-old was killed and at least five other teenagers were wounded in a shooting at Bicentennial Park.,2021
840,2021-05-22,Fort Wayne,Indiana,1,4,5,A woman was killed and four others wounded shortly after midnight. An argument had escalated in the parking lot and gunfire struck people inside their apartments.,2021
841,2021-05-22,North Charleston,South Carolina,1,14,15,A teenager was killed and fourteen injured after a shooting at an unauthorized concert.,2021
842,2021-05-22,Fairfield Township,New Jersey,2,12,14,Two people were killed and twelve others injured at a large house party in a targeted attack.,2021
843,2021-05-21,Albany,New York,1,5,6,One person was killed and five others were injured. The injured walked themselves to the hospital.,2021
844,2021-05-21,Jersey City,New Jersey,2,4,6,Two people were killed and four injured in a late night shooting.,2021
845,2021-05-20,Evansville,Indiana,0,4,4,Four people were wounded after a fight escalated into a shooting.,2021
846,2021-05-18,Hemet,California,1,4,5,A pregnant bystander was shot and killed when a fight led to gunfire on a public street and four others were wounded.,2021
847,2021-05-18,Oakland,California,2,5,7,"Seven people were shot on a party bus celebrating a birthday, two fatally. Police have offered a $40,000 reward for information about the suspect.",2021
848,2021-05-17,Portland,Oregon,0,4,4,Four people were shot on Swan Island in an incident that is described by law enforcement as gang-related.,2021
849,2021-05-16,Stone Mountain,Georgia,1,5,6,A man was killed and five injured in a drive-by shooting while standing outside a gas station.,2021
850,2021-05-16,Columbus,Georgia,0,4,4,Four people were wounded in an early morning shooting at a Waffle House.,2021
851,2021-05-16,Birmingham,Alabama,1,4,5,A suspect in a double homicide opened fire on a SWAT team attempting to carry out a search warrant. The suspect was killed and four officers wounded.,2021
852,2021-05-16,East Lansing,Michigan,0,5,5,Five people were shot at a party at an apartment complex.,2021
853,2021-05-16,Atlanta,Georgia,0,4,4,Four people were wounded leaving the Trap Music Museum in an early morning drive-by shooting.,2021
854,2021-05-16,Cincinnati,Ohio,1,3,4,Responding officers to a fight and shooting call found a man dead and three others wounded at a nightclub.,2021
855,2021-05-15,Chicago,Illinois,2,3,5,Two people were killed and three wounded at an early morning gathering in the Auburn Gresham neighborhood.,2021
856,2021-05-15,New York City,New York,1,4,5,One person was killed and four other were injured in shooting in The South Bronx.,2021
857,2021-05-15,Washington D.C.,Washington D.C.,1,3,4,A man died and two women and another man were wounded in an afternoon shooting.,2021
858,2021-05-14,Philadelphia,Pennsylvania,0,4,4,Three men and a woman were wounded in an evening shooting in West Philadelphia.,2021
859,2021-05-13,Washington D.C.,Washington D.C.,0,4,4,"Four men found in two separate locations were wounded after a man left a vehicle and opened fire in Southeast Washington, DC.",2021
860,2021-05-13,Augusta,Georgia,2,2,4,Two women died and two others were injured in an apartment shooting.,2021
861,2021-05-13,Providence,Rhode Isl,0,9,9,"Nine people were shot in Washington Park. According to police, the shooting is the largest in terms of injured in Providence's history.",2021
862,2021-05-12,Buford,Georgia,1,3,4,One person died and three were injured after a shooting at an apartment complex.,2021
863,2021-05-11,Baltimore,Maryl,0,4,4,Four people were injured in a shooting at a housing complex in West Baltimore.,2021
864,2021-05-10,Montgomery,Alabama,0,7,7,Seven people were injured in a shooting at a package store.,2021
865,2021-05-09,Phoenix,Arizona,1,7,8,Shortly after midnight a fight broke out at Hyatt Regency Phoenix in Downtown Phoenix with a man was killed and seven others wounded.,2021
866,2021-05-09,Colorado Springs,Colorado,7,0,7,2021 Colorado Springs shooting: Six people were killed when a man opened fire at a birthday party in a trailer park. The shooter  took his own life shortly afterwards.,2021
867,2021-05-08,Detroit,Michigan,0,4,4,Shortly after midnight four people were wounded in an alley in the city's Westside.,2021
868,2021-05-08,Gwynn Oak,Maryl,4,1,5,A man killed three people and injured a fourth near a townhouse before setting it on fire. Responding officers shot and killed him. The man was reportedly being watched by the FBI before the incident.,2021
869,2021-05-08,Oakland,California,0,4,4,Four people were wounded in the early morning while standing outside for a gathering near Lake Merritt.,2021
870,2021-05-08,Citrus Heights,California,0,4,4,Four people were wounded in the parking lot of a night club during the early morning. Responding officers had to break up multiple fights upon arriving.,2021
871,2021-05-07,Kinloch,Missouri,2,3,5,A fight broke out at a large outdoor party resulting in two men being killed and three others wounded.,2021
872,2021-05-06,Paterson,New Jersey,0,5,5,Five people were wounded in a drive-by shooting during the evening. Thirty minutes prior another two had been injured in a separate drive-by shooting.,2021
873,2021-05-05,Chicago,Illinois,0,4,4,Four people were shot while sitting on a porch in the South Shore neighborhood.,2021
874,2021-05-03,Saginaw,Michigan,1,4,5,A man died and four others were wounded after a shooting at a house party.,2021
875,2021-05-02,Saint Paul,Minnesota,0,4,4,A shooting at a house party left four people injured.,2021
876,2021-05-02,Columbus,Ohio,0,4,4,Three men and one woman were injured in an afternoon shooting after a man entered a restaurant and opened fire.,2021
877,2021-05-02,Chicago,Illinois,0,5,5,Two men and three women were wounded after a drive-by shooting on the West Side.,2021
878,2021-05-02,Baltimore,Maryl,1,3,4,"One person was killed, and three others injured at Carroll Park.",2021
879,2021-05-02,Philadelphia,Pennsylvania,1,3,4,One person died and three others were injured after a shooting in Frankford.,2021
880,2021-05-01,Clewiston,Florida,1,3,4,A shooting left one person dead and three injured at the Brown Sugar Festival.,2021
881,2021-05-01,New Rochelle,New York,1,4,5,A shooting left at least one dead and four more injured at an outdoor gathering.,2021
882,2021-05-01,Wilmington,Delaware,0,4,4,Two men and two women were shot and injured.,2021
883,2021-05-01,Atlanta,Georgia,1,3,4,A teenage girl and three others were wounded in a shooting.,2021
884,2021-05-01,New Orleans,Louisiana,2,4,6,Two people were killed and four more were injured in a shooting.,2021
885,2021-05-01,Ashwaubenon,Wisconsin,3,1,4,"At a casino on Oneida land, a man shot and killed 2 people, and seriously wounded another, before being shot dead by responding police officers.",2021
886,2021-05-01,Holyoke,Massachusetts,0,5,5,Five people were shot outside the Clubhouse Lounge.,2021
887,2021-04-29,Atlanta,Georgia,1,4,5,One person died and four other people were injured after a shooting at a southwest Atlanta home in a drive-by shooting.,2021
888,2021-04-28,Miami,Florida,0,5,5,Five people were injured during a shooting at a Miami home.,2021
889,2021-04-28,Boone,North Carolina,5,0,5,Two deputies were killed and three other people including a suspected gunman were found dead after a standoff.,2021
890,2021-04-27,Fairfield,Alabama,1,4,5,A shooting left at least one person dead and four more injured.,2021
891,2021-04-27,Richmond,Virginia,2,3,5,A three-month-old and her mother were killed after being caught in the crossfire between two groups. Three others are recovering after being shot.,2021
892,2021-04-26,Gresham,Oregon,0,7,7,Seven people were shot during a vigil for a shooting victim.,2021
893,2021-04-25,Palestine,Texas,0,4,4,A shooting that occurred at a local night club left four people injured.,2021
894,2021-04-25,Little Rock,Arkansas,1,3,4,A drive-by shooting left one person dead and three others injured at Cheatham Park.,2021
895,2021-04-25,Kansas City,Missouri,1,3,4,A man is dead and three more are injured after a quadruple shooting in the city's historic jazz district.,2021
896,2021-04-25,Phenix City,Alabama,0,4,4,An overnight shooting left four people injured at an outdoor party.,2021
897,2021-04-25,Houma,Louisiana,0,5,5,A shooting at a Houma nightclub left five people injured.,2021
898,2021-04-24,New Orleans,Louisiana,0,5,5,Five people were wounded in a shooting on Bourbon Street.,2021
899,2021-04-22,San Diego,California,1,4,5,A man was arrested after two overnight shootings in downtown San Diego left one person dead and four others injured.,2021
900,2021-04-19,Saint Croix,United States Virgin Isls,2,2,4,"Four people were shot, two fatally, at a housing complex.",2021
901,2021-04-19,Houston,Texas,2,3,5,"Five people were shot, two fatally, in Independence Heights.",2021
902,2021-04-19,Atlanta,Georgia,0,5,5,"Five people were wounded, one critically, at an apartment complex in southwest Atlanta.",2021
903,2021-04-18,Montgomery,Alabama,1,4,5,"A shooting over the weekend left four people injured, including juveniles, and one woman dead.",2021
904,2021-04-18,Detroit,Michigan,1,5,6,"Police were investigating a shooting that wounded five, as well as a fatal car crash nearby, when a man drove through the crime scene and later fired at officers. Officers then fired back, killing the man. It is not known if this man was connected to the earlier shooting.",2021
905,2021-04-18,Kenosha,Wisconsin,3,2,5,Three people were killed and two injured after a shooting at a tavern.,2021
906,2021-04-18,Shreveport,Louisiana,0,5,5,Five victims have shown up at a Shreveport hospital in connection with a shooting on Hearne Avenue.,2021
907,2021-04-17,LaPlace,Louisiana,0,9,9,Nine people were shot and injured during a 12-year old's birthday party.,2021
908,2021-04-17,Columbus,Ohio,1,5,6,A woman was killed and five were wounded after a shooting at a vigil for a homicide victim.,2021
909,2021-04-16,Detroit,Michigan,0,4,4,Four people were shot at a vigil on the East Side.,2021
910,2021-04-15,Indianapolis,Indiana,9,7,16,"Indianapolis FedEx shooting: A shooting occurred outside a FedEx facility near Indianapolis International Airport. Nine people were reported dead, including the shooter, who committed suicide. The shooter has been identified as 19-year old Brandon Scott Hole, a former employee of the FedEx facility.",2021
911,2021-04-15,Washington D.C.,Washington D.C.,0,4,4,Three men and a teenage girl were wounded in Northeast DC.,2021
912,2021-04-15,Pensacola,Florida,0,5,5,Five people were shot outside an apartment complex. Police say there were four shooters.,2021
913,2021-04-15,Chicago,Illinois,0,4,4,Four people were wounded in Humboldt Park.,2021
914,2021-04-13,Baltimore,Maryl,0,4,4,Four men were shot by at least two people while playing a dice game in East Baltimore.,2021
915,2021-04-12,Chicago,Illinois,1,3,4,"Four people were shot, one fatally, on the I-290. In addition, a fifth person was hit by a car.",2021
916,2021-04-12,Nashville,Tennessee,1,3,4,A three-year-old girl was shot and killed; a two-year-old girl and two adult males were shot and injured in the Cumberland View apartments of the North Nashville neighborhood.,2021
917,2021-04-12,Carroll County,Georgia,1,3,4,"During a vehicle pursuit, three police officers were shot and one of the occupants of the suspect vehicle was killed by police.",2021
918,2021-04-11,Wichita,Kansas,1,3,4,One man was killed and three others wounded at an Airbnb.,2021
919,2021-04-11,Seattle,Washington,0,5,5,Five people were shot in a parking lot.,2021
920,2021-04-10,Koshkonong,Missouri,1,3,4,"A man shot several people at a convenience store. Police say the man knew one of the victims, but the motive is unclear.",2021
921,2021-04-10,Memphis,Tennessee,1,4,5,Five people were shot at an auto repair shop.,2021
922,2021-04-10,Waterbury,Connecticut,0,4,4,Four people were wounded in a shooting.,2021
923,2021-04-10,Allendale,Michigan,0,4,4,"A shooting at an Allendale apartment complex near Grand Valley State University injured four people, leaving one critically injured.",2021
924,2021-04-09,Fort Worth,Texas,1,5,6,"Six people were shot, one fatally, during a shootout between two vehicles. Police say the shooting may have been gang related. One of the wounded was in a non-related vehicle, and another was in his home.",2021
925,2021-04-08,Bryan,Texas,1,5,6,"A shooting at a cabinet manufacturing store left one person dead, four in critical condition, and one in stable condition. One of the injured is a Texas State Trooper. The suspected shooter is now in custody.",2021
926,2021-04-07,Rock Hill,South Carolina,7,0,7,"2021 Rock Hill shooting: Six people, including two children, were killed in a mass shooting at a Rock Hill home. The perpetrator, a former professional NFL player was found dead by suicide in a nearby home.",2021
927,2021-04-07,Milwaukee,Wisconsin,2,2,4,"Four people were shot at a Northside gas station, two of them fatally.",2021
928,2021-04-06,New York City,New York,4,0,4,"A man killed the mother of his child and two of her daughters, then later killed himself at the New York City Housing Authority's Van Dyke Houses Brownsville neighborhood of Brooklyn.",2021
929,2021-04-06,Detroit,Michigan,1,3,4,Four people were shot in the Cornerstone Village neighborhood.,2021
930,2021-04-05,Chicago,Illinois,0,7,7,Seven people were injured in a shooting in West Englewood.,2021
931,2021-04-05,Baltimore,Maryl,0,5,5,Five men were injured in a shooting.,2021
932,2021-04-05,Allen,Texas,6,0,6,Two brothers are suspected to have made a suicide pact before they shot and killed four family members and then fatally shot themselves in a suburban home.,2021
933,2021-04-04,Monroe,Louisiana,0,6,6,Two men were arrested for a shooting at a bar that wounded six people.,2021
934,2021-04-04,Birmingham,Alabama,1,6,7,"A woman was killed at a park, and six others, including a 5-year-old boy, were wounded.",2021
935,2021-04-04,Beaumont,Texas,0,4,4,Four people were wounded in a drive-by shooting.,2021
936,2021-04-03,Wilmington,North Carolina,3,4,7,"Seven people were shot, three fatally, during a house party.",2021
937,2021-04-03,Quincy,Florida,0,7,7,Seven were wounded after a nightclub shooting.,2021
938,2021-04-03,Tuscaloosa,Alabama,0,5,5,Two people were arrested after a shooting injured five people.,2021
939,2021-03-31,Orange,California,4,2,6,"2021 Orange, California office shooting: Six people were shot. Four people, including a child, were killed and two hospitalized.",2021
940,2021-03-31,Washington D.C.,Washington D.C.,2,3,5,Five people were shot in the Congress Heights neighborhood. Two of the victims were killed and three others were injured.,2021
941,2021-03-30,Houston,Texas,0,4,4,Several people were wounded in the Acres Homes area in separate shootings. Houston Police believe the shootings may be connected.,2021
942,2021-03-28,Essex,Maryl,5,1,6,A man killed his parents and two others before setting himself on fire. A fifth person was wounded by gunfire but survived.,2021
943,2021-03-28,Chicago,Illinois,0,4,4,Four people were struck by gunfire on a vehicle on Interstate 57.,2021
944,2021-03-28,San Antonio,Texas,0,4,4,"Four people were injured, two critically, after a shooting at an apartment complex.",2021
945,2021-03-28,Cleveland,Ohio,0,7,7,Seven people were injured after a shootout at a motorcycle club.,2021
946,2021-03-27,Chicago,Illinois,0,4,4,Four people were wounded after a shooting in the Austin neighborhood.,2021
947,2021-03-27,River Grove,Illinois,1,3,4,"Four people were shot, one fatally, on a party bus.",2021
948,2021-03-27,Yazoo City,Mississippi,0,6,6,Several people were injured after a shooting at a nightclub.,2021
949,2021-03-27,Memphis,Tennessee,3,2,5,"In an early morning shooting in Northern Memphis, three people were killed and two people were injured. Of the injured, a man is in critical condition and a woman is in stable condition.",2021
950,2021-03-26,Philadelphia,Pennsylvania,0,7,7,"Seven people were shot outside a sports bar in Fishtown. Three of the victims are in critical condition, and four are in stable condition.",2021
951,2021-03-26,Virginia Beach,Virginia,2,8,8,"Eight people were injured after a fight led to a shooting. Two other shootings, one of which was officer-involved, also occurred that night, though it is unknown if they were related to the original shooting.",2021
952,2021-03-26,Chicago,Illinois,1,7,8,One person died and seven others were injured at a party in the Southwest Side of Chicago.,2021
953,2021-03-23,Atlanta,Georgia,0,4,4,"Four people including a child were injured at the entrance of the Cumberland Mall, although the mall was not evacuated. A similar shooting took place in December 2019.",2021
954,2021-03-23,Aliceville,Alabama,2,2,4,"Four people, including two high school students, were shot. One of the high school students later died.",2021
955,2021-03-22,Detroit,Michigan,1,3,4,"Four people were shot in a vehicle, one fatally.",2021
956,2021-03-22,Cleveland,Ohio,2,2,4,"Four people were shot at a restaurant, two fatally.",2021
957,2021-03-22,Boulder,Colorado,10,2,12,"2021 Boulder shooting: Ten people were killed including a Boulder police officer, in a shooting at a grocery store. The shooter was shot in the leg by responding police.",2021
958,2021-03-20,Houston,Texas,0,5,5,Five people were shot at a nightclub.,2021
959,2021-03-20,Philadelphia,Pennsylvania,1,4,5,"Five people were shot, one fatally, at a party in the Nicetown neighborhood.",2021
960,2021-03-20,Dallas,Texas,1,7,8,One person died and seven others were wounded after a shooting at a nightclub.,2021
961,2021-03-18,New Orleans,Louisiana,0,4,4,Four people were shot in the 7th Ward.,2021
962,2021-03-18,Gresham,Oregon,0,4,4,Four people were hospitalized after a shooting at a motel.,2021
963,2021-03-17,Stockton,California,0,5,5,Five people were wounded after a drive-by shooting at a vigil. Police say the victims are uncooperative.,2021
964,2021-03-16,Phoenix,Arizona,4,1,5,Four people died after a shooting at a home. One man was injured and is expected to survive.,2021
965,2021-03-16,Atlanta  and Acworth,Georgia,8,1,9,"2021 Atlanta spa shootings: A series of mass shootings occurred at massage parlors. Eight people were killed in the incidents and one person was wounded, six victims were women of Asian descent. The suspect was arrested in Crisp County and told police he planned to continue his massacre in Florida.",2021
966,2021-03-15,Indianapolis,Indiana,1,4,5,One person died and four were injured after an overnight shooting in the Northside.,2021
967,2021-03-14,Chicago,Illinois,0,4,4,Four people were injured during a robbery in the South Side.,2021
968,2021-03-14,Chicago,Illinois,2,13,15,Two people were killed and 13 injured at an early morning party in South Side.,2021
969,2021-03-14,Tampa,Florida,0,4,4,Four people were shot outside a banquet hall.,2021
970,2021-03-13,Indianapolis,Indiana,4,1,5,"Police found a woman who had been shot and learned there may be other victims at a different home. Police arrived at the home and found four dead, including a child.",2021
971,2021-03-13,Orlando,Florida,1,3,4,One person was killed and three injured at an early morning party.,2021
972,2021-03-13,New York City,New York,0,5,5,"Five people were shot at a hookah parlor in Williamsburg, Brooklyn.",2021
973,2021-03-13,Richmond,Virginia,2,4,6,Two people were killed and four injured at a parking lot.,2021
974,2021-03-12,Greensboro,North Carolina,0,4,4,"Four people, including a minor, were injured in a shooting.",2021
975,2021-03-11,Chamita,New Mexico,1,3,4,"Following an argument, a man shot at a car of people, killing one and wounding three.",2021
976,2021-03-11,Columbia,South Carolina,1,4,5,One person was killed and four injured outside a motorcycle business.,2021
977,2021-03-11,Philadelphia,Pennsylvania,2,2,4,"Four people were shot in Overbrook, two fatally. One of the deceased was 16-years-old.",2021
978,2021-03-10,Philadelphia,Pennsylvania,0,4,4,Four people were shot in Kensington.,2021
979,2021-03-10,Houston,Texas,3,1,4,Three people were killed and one was injured in Southwest Houston. Two of the victims were 18-years-old.,2021
980,2021-03-08,Clearwater,Florida,1,3,4,One man died and three people were injured in a shooting. Police believe the shooting was targeted.,2021
981,2021-03-07,Edwards,Mississippi,0,4,4,"Three adults and a two-year-old child were injured at a child's birthday party, in a local apartment building. The shooter was arrested the next day.",2021
982,2021-03-06,Yuba City,California,2,3,5,Two were killed and three injured after a drive-by shooting at a backyard gathering.,2021
983,2021-03-06,Fayetteville,North Carolina,1,4,5,One man was killed and four people were injured in an early-morning shooting.,2021
984,2021-03-05,Compton,California,1,4,5,A shooting at a restaurant killed a man from Pennsylvania and injured four others. Police say the shooting was gang-related.,2021
985,2021-03-04,Washington D.C.,Washington D.C.,0,5,5,Several people were injured in a shooting at a convenience store in the Southwest section of the district.,2021
986,2021-03-03,Erie,Pennsylvania,1,3,4,One person died and three were injured after a shooting at a tavern.,2021
987,2021-02-28,Houston,Texas,0,4,4,Four people were injured at a parking lot in Northwest Houston. Police say the incident was a case of road rage.,2021
988,2021-02-28,McCormick,South Carolina,0,4,4,Four people were shot at an apartment complex. The shooting occurred at one of the wounded's apartments.,2021
989,2021-02-28,Dover,Delaware,0,4,4,Four people were wounded in an IHOP parking lot during the early morning.,2021
990,2021-02-28,Shreveport,Louisiana,0,5,5,"Five people were wounded in a drive-by shooting. Four were outside, and one was in a store.",2021
991,2021-02-28,Frederiksted,United States Virgin Isls,2,2,4,"Four people were shot, two fatally, at a vegetable market. One of the wounded was involved in a crash on her way to the hospital.",2021
992,2021-02-28,East Chicago,Indiana,0,4,4,Four people were shot at a gas station. One of the wounded was a 7-year-old girl.,2021
993,2021-02-28,Cincinnati,Ohio,4,2,6,"A man shot and killed his wife and two others, wounding a fourth. He was later shot and injured by police in Detroit and was taken to a nearby hospital and died days later.",2021
994,2021-02-27,Columbus,Mississippi,0,4,4,Four people were injured after a shooting in South Columbus.,2021
995,2021-02-27,Pattison,Mississippi,2,3,5,"A conflict between two men led to a shooting at a birthday party, killing two and injuring three.",2021
996,2021-02-27,Saint Croix,United States Virgin Isls,1,5,6,"Six people were shot, one fatally, after a dispute at a club.",2021
997,2021-02-26,San Diego,California,1,3,4,"Four were shot, one fatally, after a drive-by shooting outside a market.",2021
998,2021-02-26,Houston,Texas,1,5,6,"Six men were injured at a local car wash, with one man found by police and five others identified at a local hospital.",2021
999,2021-02-26,Baton Rouge,Louisiana,0,4,4,Four people were shot and injured on Paige Street.,2021
1000,2021-02-21,Teachey,North Carolina,0,4,4,Four people were wounded after a shooting at a mobile home park.,2021
1001,2021-02-21,Kennett,Missouri,1,4,5,One man died and four people were injured after an overnight shooting at a club.,2021
1002,2021-02-20,Metairie,Louisiana,3,2,5,"A man shot and killed two people at a gun store. Several people then engaged the original shooter both inside and outside the store, causing injuries to two more people. It is still unclear whether the original shooter was shot dead by engaging responders or committed suicide.",2021
1003,2021-02-20,Springfield,Illinois,1,4,5,One man died and four people were injured after an overnight shooting in Springfield.,2021
1004,2021-02-20,East Norriton,Pennsylvania,1,3,4,One man died and three people were injured after a shooting at a bowling alley.,2021
1005,2021-02-19,Grand Junction,Colorado,1,3,4,"Four people were shot, one fatally, at a party. Most of the people at the party were of college-age.",2021
1006,2021-02-18,Baton Rouge,Louisiana,1,3,4,A man was killed and three others injured inside a barbershop.,2021
1007,2021-02-17,Philadelphia,Pennsylvania,0,8,8,"A shooter injured eight people, including a seventeen-year-old, near the Olney Transportation Center.",2021
1008,2021-02-16,St. Petersburg,Florida,3,1,4,"A man suspected in a homicide shot several family members at a house where his grandmother and great-grandmother lived, killing them and his uncle. A woman with gunshot wounds was able to escape to a neighbor's house for help.",2021
1009,2021-02-13,Indianapolis,Indiana,0,4,4,One adult and three juveniles were discovered wounded by gunfire in a vehicle stopped at an intersection.,2021
1010,2021-02-13,Cary,North Carolina,1,3,4,One person died and three others were wounded in an early morning shooting.,2021
1011,2021-02-13,Oakland,California,0,6,6,Six wounded men were found after a Shot Spotter alert in the Old Oakland Historic District. The victims are uncooperative with officers.,2021
1012,2021-02-13,San Francisco,California,0,6,6,A shooting in Bayview injured six people.,2021
1013,2021-02-11,Columbus,Georgia,1,4,5,"Five people were shot, one fatally in an evening shooting near the Signature Event Center.",2021
1014,2021-02-10,Atlanta,Georgia,0,4,4,Four people were injured during a shootout between two vehicles. Two of the injured were minors.,2021
1015,2021-02-09,Houston,Texas,0,4,4,Four men were shot and injured in a drive-by shooting at Acres Homes.,2021
1016,2021-02-09,Buffalo,Minnesota,1,4,5,"Buffalo, Minnesota clinic attack: A nurse was killed and four other people were shot and seriously wounded inside of a health care clinic. The perpetrator had made previous threats to commit a mass shooting at the clinic.",2021
1017,2021-02-08,Mobile,Alabama,0,4,4,Three adults and a juvenile were shot and injured in an evening shooting.,2021
1018,2021-02-06,Thibodaux,Louisiana,0,4,4,Three teens and one adult were shot at a house party.,2021
1019,2021-02-06,Tacoma,Washington,1,3,4,A shooting at an illegal club killed one and injured three.,2021
1020,2021-02-06,Murfreesboro,Tennessee,1,4,5,One man was killed in a shooting at a party while two others were hospitalized. Another two were grazed by bullets but refused treatment.,2021
1021,2021-02-06,Bloomingdale,Illinois,1,5,6,A shooting at a hotel killed one man and wounded five others.,2021
1022,2021-02-05,Martinsville,Virginia,2,2,4,"Two were killed in a shooting at a restaurant, while two others were injured. One of the shooters engaged in a gunfight with the police.",2021
1023,2021-02-05,Mohnton,Pennsylvania,1,3,4,"Four men were shot at a hookah lounge, one fatally.",2021
1024,2021-02-05,Bolivar,Mississippi,3,1,4,A shooting at a club left three people dead and one injured.,2021
1025,2021-02-04,High Point,North Carolina,2,3,5,"During a hostage situation, a man killed a woman and shot three officers. The man was later killed by police.",2021
1026,2021-02-03,Memphis,Tennessee,1,3,4,One person died in North Memphis and three others were injured in a shooting.,2021
1027,2021-02-03,Colorado Springs,Colorado,3,1,4,"A shooter attacked four people at an apartment complex near Fort Carson, killing three.",2021
1028,2021-02-03,Oak Creek,Colorado,2,3,5,"Police discovered a wounded man, who told them he had been shot by another man. The shooter was discovered shortly afterward in a home where he killed one and injured two before being killed by a resident of the home.",2021
1029,2021-02-02,Sunrise,Florida,3,3,6,"2021 Sunrise, Florida shootout: Two FBI agents were shot and killed and three others wounded attempting to serve a warrant. The suspect barricaded himself in his home and opened fire before shooting and killing himself.",2021
1030,2021-02-02,Muskogee,Oklahoma,6,1,7,"2021 Muskogee shooting: Five children and one adult were shot and killed, and one other adult suffered life-threatening injuries, after a home shooting. The slain adult was the adult brother of the perpetrator.",2021
1031,2021-02-01,Rochester,New York,1,3,4,A man was killed and a woman and two men injured in the early morning.,2021
1032,2021-01-30,Albany,New York,1,4,5,"A woman was shot and killed, and four other people were injured after a shooting.",2021
1033,2021-01-29,McKees Rocks,Pennsylvania,2,3,5,Two people were killed and three others injured after a shooting outside a club.,2021
1034,2021-01-28,Flint,Michigan,1,4,5,"A woman was killed and four others, including a baby boy, were injured in a drive-by shooting.",2021
1035,2021-01-27,Santa Ana,California,0,4,4,Four men were wounded in the early morning at an illegal gambling den.,2021
1036,2021-01-25,Washington D.C.,Washington D.C.,1,4,5,A shooting at a market killed a Virginia Union University student and wounded four others in the Southeast section of the nation's capital.,2021
1037,2021-01-24,Las Vegas,Nevada,0,5,5,"Five people were hospitalized in a shooting, two in critical condition.",2021
1038,2021-01-24,Indianapolis,Indiana,6,1,7,Six people including a pregnant woman were killed and a teen was injured in a shooting at a house on the northeast side of Indianapolis. The teen suspect  is currently in custody.,2021
1039,2021-01-22,Covington,Kentucky,0,5,5,Five people were injured in a shooting at a bar. A suspect was arrested.,2021
1040,2021-01-21,Oakland,California,1,3,4,"One person died during a shoot-out in East Oakland, while three others were injured. The man who died was hit by a stray bullet.",2021
1041,2021-01-20,Crowley,Louisiana,0,4,4,Four people were injured in a shooting just outside Crowley city limits.,2021
1042,2021-01-18,Tobyhanna,Pennsylvania,0,4,4,Four people were wounded in a string of connected shootings at three different locations.,2021
1043,2021-01-17,Phoenix,Arizona,0,5,5,Five men were injured during a shooting near a strip mall. Police think there may have been a shootout.,2021
1044,2021-01-17,Phoenix,Arizona,1,6,7,A shooting at a nightclub killed one and injured six.,2021
1045,2021-01-16,Kankakee,Illinois,0,5,5,Four men and a woman were injured in an early morning shooting after an attendee at a house party opened fire.,2021
1046,2021-01-16,San Francisco,California,0,5,5,Five people were wounded after a shooting in the Tenderloin district.,2021
1047,2021-01-15,Philadelphia,Pennsylvania,0,4,4,Four teenagers were injured in a shooting in the Logan neighborhood of North Philadelphia.,2021
1048,2021-01-11,Miami,Florida,0,4,4,Four teenagers were shot outside an apartment complex in Brownsville in the third mass shooting in Metropolitan Miami in eight days.,2021
1049,2021-01-09,Houston,Texas,1,3,4,"A shooting at a nightclub left one person, a teenager, dead, and three others injured.",2021
1050,2021-01-09,Chicago  and Evanston,Illinois,6,2,8,A shooting that started in Chicago ended in Evanston left five people dead and two injured before the shooter was shot and killed by police.,2021
1051,2021-01-07,Washington D.C.,Washington D.C.,0,5,5,Three men and two boys were wounded in an evening shooting in Columbia Heights.,2021
1052,2021-01-06,Manassas,Virginia,1,3,4,A man opened fire on his family killing one man and injuring two women and a teenage boy before fleeing. He was discovered later by officers after dying in a car accident.,2021
1053,2021-01-06,Livingston,Texas,1,3,4,"Three men attempted to break into a home, and engaged in a gunfight with an occupant. The occupant was killed and two adults and a three-year-old girl were injured.",2021
1054,2021-01-05,Tampa,Florida,0,5,5,A shootout injured five people near a convenience store in the Palm River-Clair Mel area.,2021
1055,2021-01-04,Lauderhill,Florida,0,7,7,Seven people were injured in a shooting.,2021
1056,2021-01-04,New Orleans,Louisiana,0,4,4,"Three men and a fifteen-year-old boy were involved in a shoot-out in the 7th ward, and subsequently wounded by gunfire.",2021
1057,2021-01-03,Houston,Texas,1,4,5,"A fight broke out, outside a Midtown Houston nightclub and a man opened fire. Three officers working a second job as security were wounded, along with the shooter, and a woman, who was the mother of the shooter, was killed.",2021
1058,2021-01-03,Shreveport,Louisiana,2,3,5,Two groups of men opened fire at one another in the early morning. Two were killed and three wounded in the shooting.,2021
1059,2021-01-03,Santa Barbara,California,2,2,4,Two people were killed and two injured after another approached the group on foot and opened fire in the city's lower Eastside.,2021
1060,2021-01-03,Miami,Florida,0,4,4,Four people were wounded outside a nightclub in the evening.,2021
1061,2021-01-03,Gresham,Oregon,0,4,4,Four people were wounded at a private party.,2021
1062,2021-01-03,Miami,Florida,0,8,8,"Six adults and two teenagers were wounded at a basketball court in Little River Park in Northwest Miami-Dade, when two people walked up and opened fire.",2021
1063,2021-01-01,Fort Smith,Arkansas,0,7,7,Seven people were wounded in an early morning shooting at an event center hosting a New Year's party after two men in a disagreement shot at each other.,2021
1064,2021-01-01,Sioux City,Iowa,1,4,5,"A woman was killed and four others injured after a shooting occurred at a house party. Multiple guns fired into the house, and attendees fled and drove themselves to different hospitals.",2021
1065,2021-01-01,Amarillo,Texas,1,3,4,A man was killed and three others injured in an early morning shooting at a shopping center.,2021
1066,2021-01-01,Galesburg,Illinois,0,4,4,Four people were wounded in an early morning shooting while at home. Police believe the shooting was targeted.,2021
1067,2020-12-31,Happy Valley,Oregon,0,4,4,Four people were wounded after a shooting at a party. All four are expected to survive.,2020
1068,2020-12-31,Indianapolis,Indiana,1,3,4,A shooting unfolded outside a nightclub on New Year's Eve that killed a man and sent three others to the hospital.,2020
1069,2020-12-27,Smith Bay,United States Virgin Isls,1,3,4,Four men were wounded after a shooting near a restaurant. One of the wounded later died from his injuries.,2020
1070,2020-12-26,Lynn,Massachusetts,1,5,6,Six people were wounded in an evening shooting. One of the victims later died at the hospital.,2020
1071,2020-12-26,Miami,Florida,1,3,4,Three adults and a juvenile were wounded in an afternoon drive-by shooting. One of the wounded later died at the hospital.,2020
1072,2020-12-26,Tampa,Florida,2,2,4,Two men were killed and two injured in an early morning targeted shooting in Ybor City.,2020
1073,2020-12-26,Rockford,Illinois,3,3,6,Don Carter Lanes shooting: Three people are killed and three others injured in a shooting at a bowling alley. The shooter is believed to have selected his victims at random. A person of interest has been taken into custody by authorities.,2020
1074,2020-12-25,Atkins,Arkansas,5,0,5,"Five females aged between eight and fifty; three were children, were found killed by a family member. Police believe it was domestic related.",2020
1075,2020-12-25,Boynton Beach,Florida,1,4,5,Four people were injured and one was killed after a shooting on Christmas Day.,2020
1076,2020-12-24,Lakeland,Florida,1,4,5,"After a teenager got into a conflict with another group, four people were injured and one was killed after a shooting at the teenager's home.",2020
1077,2020-12-22,Meridian,Mississippi,5,0,5,Four individuals were discovered killed in three separate homes after wellness checks were called for them. The perpetrator died of a self inflicted gunshot wound.,2020
1078,2020-12-20,Mayfield,Kentucky,4,0,4,"A wife, husband, and two children were fatally shot inside of their home.",2020
1079,2020-12-20,Bridgeport,Connecticut,2,2,4,Two men were killed at a sports bar in an apparent targeted shooting. Two innocent bystanders were wounded.,2020
1080,2020-12-19,Chicago,Illinois,0,6,6,"Six people were wounded after someone walked into and opened fire inside a South Side beauty salon in the Burnside neighborhood, shortly after midnight. The salon was hosting an after hours party.",2020
1081,2020-12-18,Philadelphia,Pennsylvania,0,4,4,Three men and a woman were shot in the Kingsessing neighborhood. Cocaine and firearms were recovered on the scene.,2020
1082,2020-12-14,St. Louis,Missouri,0,4,4,Following a dispute outside of a restaurant four were people shot.,2020
1083,2020-12-13,Elkview,West Virginia,4,0,4,"A family member discovered two parents and two children, aged 12 and 13-years-old, killed in their home. The killer was reportedly a third teenaged child of the family.",2020
1084,2020-12-12,New York City,New York,0,4,4,Four men were wounded in an afternoon shooting in the Boerum Hill neighborhood of Brooklyn.,2020
1085,2020-12-12,Landover,Maryl,1,3,4,A man was killed and three others wounded at a large early morning gathering.,2020
1086,2020-12-12,San Bernardino,California,1,3,4,A man was killed and three others wounded in an early morning shooting.,2020
1087,2020-12-12,Copiague,New York,1,3,4,A man was killed and three others were wounded inside a deli.,2020
1088,2020-12-10,Jackson,Mississippi,0,5,5,Five men were wounded in a late night shooting. They were playing dice outside an apartment complex when a man drove up and started shooting. The man chased them through the complex before fleeing.,2020
1089,2020-12-10,Tifton,Georgia,0,4,4,Four people were wounded near the Charles Spencer Elementary School during school hours. No students were harmed or in danger.,2020
1090,2020-12-10,Metairie,Louisiana,2,2,4,Two people were killed and two wounded in a parking lot after an SUV pulled into it.,2020
1091,2020-12-08,Lacombe,Louisiana,2,3,5,A group of four men attempted to rob a home at gun point. The home owner opened fire in defense and killed two of the robbers and wounded the other two. The homeowner's four-year-old child was also wounded.,2020
1092,2020-12-06,Venus,Texas,0,6,6,"Six people were wounded at a rodeo outdoor live music venue, with one to two thousand attendees present. Police had been called to the venue three times prior to the shooting, due to fights.",2020
1093,2020-12-05,Autryville,North Carolina,0,6,6,Shortly before midnight an argument between two men at a bonfire escalated. Six people were wounded.,2020
1094,2020-12-05,Hayward,California,1,3,4,Officers responding to reports of a shooting shortly after midnight found a woman dead and three other individuals injured.,2020
1095,2020-12-04,Chicago,Illinois,0,4,4,Three men and a seventeen-year-old girl were injured after someone shot at them from across the street. The group was standing outside a home in West Garfield Park.,2020
1096,2020-12-01,Morrisville,Pennsylvania,1,3,4,An eighteen-year-old was killed and three other teenagers were injured after a dispute between two groups escalated.,2020
1097,2020-11-30,Palmer,Alaska,4,0,4,"A man was killed, and shortly later a woman and two children; aged 10 and 7-years-old were killed at a home. An additional child was found uninjured in the home.",2020
1098,2020-11-29,Memphis,Tennessee,2,2,4,Two people were killed and two wounded in an apartment complex near Memphis International Airport.,2020
1099,2020-11-29,Grenada,Mississippi,0,11,11,Eleven people were shot at a motorcycle club. The injured were treated at nearby hospitals and no arrests have been made.,2020
1100,2020-11-28,New Orleans,Louisiana,0,4,4,"Four people were shot in the evening, in New Orleans East.",2020
1101,2020-11-28,Aiken,South Carolina,1,14,15,A man was killed and fourteen other people were injured shortly after midnight at a nightclub. At least three men fled in a vehicle and continued to fire from the vehicle.,2020
1102,2020-11-27,Toledo,Ohio,0,6,6,Five people were wounded while leaving a club in the early morning. A sixth person was wounded by a stray bullet while at home.,2020
1103,2020-11-27,Macon,Georgia,1,5,6,A woman was killed and five people wounded by gunfire and two stabbed outside a nightclub after an early morning argument.,2020
1104,2020-11-26,Henderson,Nevada,1,4,5,"One person was killed and four injured in a shooting outside a 7-Eleven store. The possible suspects were arrested on other charges in nearby Parker, Arizona.",2020
1105,2020-11-22,New York City,New York,1,6,7,A woman was killed and six others were injured at a party in the Bedford–Stuyvesant neighborhood of Brooklyn.,2020
1106,2020-11-22,Trenton,New Jersey,0,4,4,Four people were wounded in an evening shooting in the Stuyvesant area.,2020
1107,2020-11-21,Bellevue,Nebraska,2,2,4,Two people were killed and two others wounded at a Sonic Drive-In after police responded to a call of a bomb inside a truck. A suspect has been arrested.,2020
1108,2020-11-21,Phoenix,Arizona,1,4,5,A woman was killed and three adults and a teenager were wounded at an illegal warehouse party.,2020
1109,2020-11-21,Chicago,Illinois,0,6,6,Six people were wounded in an early morning shooting in Gresham on the South Side after a man opened fire on them from the sidewalk.,2020
1110,2020-11-20,Elberta,Michigan,3,1,4,"A family of four, a husband and wife and their two adult sons, were shot in their home. The husband is in critical condition at a local hospital. A recently discharged gun was found at the scene and police do not believe there is a suspect at large.",2020
1111,2020-11-20,Wauwatosa,Wisconsin,0,8,8,"Mayfair Mall shooting: Eight people were hospitalized with non-life-threatening injuries after a person opened fire at the Mayfair Mall. Several people, including a 15-year-old boy from Milwaukee, have been arrested in the case.",2020
1112,2020-11-19,Haines City,Florida,1,3,4,One person was killed and three injured in a drive-by shooting while standing under a carport.,2020
1113,2020-11-18,Florence,South Carolina,0,4,4,Four people were wounded in an evening shooting.,2020
1114,2020-11-18,Houston,Texas,3,2,5,A man shot and killed his uncle and cousin and wounded his wife and aunt before committing suicide. His uninjured infant daughter was also in the home.,2020
1115,2020-11-17,Jackson,Tennessee,0,4,4,Four people were wounded at a home that had been the site of a break in back in January 2020.,2020
1116,2020-11-16,Chicago,Illinois,0,4,4,Four people were wounded at the Dearborn homes after another group began an argument which escalated.,2020
1117,2020-11-16,Miami,Florida,0,4,4,Two adults and two children under the age of seven were wounded in a drive-by shooting. They were standing outside a home in Golden Glades.,2020
1118,2020-11-16,Chicago,Illinois,0,4,4,Four people were wounded in a drive-by shooting while walking down a road on the West Side. Two of the wounded were teenage girls.,2020
1119,2020-11-15,Riverdale,Georgia,2,2,4,Two men were killed and two injured at a trailer park in a late night shooting.,2020
1120,2020-11-15,Shreveport,Louisiana,0,5,5,Five people were shot shortly after midnight while attending a street gathering.,2020
1121,2020-11-14,Sumter,South Carolina,3,1,4,"Shortly before midnight, three people were killed and a pregnant woman wounded in a home.",2020
1122,2020-11-14,Riverside,California,2,3,5,Officers responding to an assault with a deadly weapon call found two men who later died at a hospital. Three additional wounded individuals were identified at a hospital.,2020
1123,2020-11-14,Cincinnati,Ohio,0,4,4,"Four teenagers, aged between twelve and fifteen, were wounded in an evening drive by shooting in the Winton Hills area.",2020
1124,2020-11-14,Fulton,Missouri,0,4,4,Four people were wounded in a late night shooting at an event center. The center had been rented out for a birthday party prior to the shooting.,2020
1125,2020-11-12,Gastonia,North Carolina,0,6,6,"Six people were shot, including two police officers, when an argument inside a nightclub escalated.",2020
1126,2020-11-12,Tampa,Florida,2,4,6,Officers responding to reports of multiple gunshots found two men dead and four wounded in an evening shooting.,2020
1127,2020-11-10,Tampa,Florida,1,7,8,A man was killed and seven other men and teenagers were wounded in a drive-by shooting. A car opened fire on a group gathered at a basketball court next to a Boys & Girls Club.,2020
1128,2020-11-09,Fort Worth,Texas,0,4,4,Two adults and two children were wounded in an afternoon shooting at a local food mart. Police are investigating it as possible gang activity.,2020
1129,2020-11-08,Nashville,Tennessee,0,8,8,Eight people and a dog were injured in a shooting on Commerce Street in the early hours of the morning.,2020
1130,2020-11-08,Virginia Beach,Virginia,0,4,4,Two adults and two children under the age of twelve were wounded in a gated apartment complex.,2020
1131,2020-11-07,Rock Hill,South Carolina,1,3,4,One individual was killed and three injured inside a local bar shortly after midnight.,2020
1132,2020-11-07,Ogden,Kansas,0,4,4,Four men were wounded outside a local bar shortly before midnight.,2020
1133,2020-11-06,New Orleans,Louisiana,2,2,4,Two people were wounded and two killed in the Hollygrove section of the city. One of those killed may have been the target of the shooting.,2020
1134,2020-11-05,Toledo,Ohio,3,1,4,Three people were killed and one injured near an apartment complex. The shooting is believed to be connected to a hit and run accident just down the road.,2020
1135,2020-11-04,Jefferson City,Missouri,0,4,4,Four people were wounded in a shooting in a parking lot at a local sporting complex and gym located near the Jefferson City High School.,2020
1136,2020-11-03,Henderson,Nevada,4,1,5,Henderson shooting: A man shot and killed three people at an apartment complex before being shot dead by police. A fifth person was taken to a hospital with gunshot wounds but the condition of the person was not yet known.,2020
1137,2020-11-01,Winston-Salem,North Carolina,1,3,4,A man was killed and three others wounded shortly after midnight. A suspect was arrested shortly after.,2020
1138,2020-11-01,Evansville,Indiana,0,4,4,Four people were wounded outside of a bar after an early morning argument escalated in a large crowd. The bar was the scene of a similar shooting in February 2019.,2020
1139,2020-11-01,Atlantic City,New Jersey,1,3,4,A man was killed and three wounded near a local bar that was hosting a Halloween party in the early morning.,2020
1140,2020-11-01,Hollywood,South Carolina,0,6,6,Six people were wounded in an early morning shooting at a party in an abandoned house.,2020
1141,2020-11-01,Rochester,New York,2,2,4,"Two men were killed and two wounded outside an apartment building that was hosting a Halloween party, in the early morning.",2020
1142,2020-11-01,Oklahoma City,Oklahoma,1,3,4,A man was killed and three others injured after someone fired into an event center.,2020
1143,2020-11-01,Tucson,Arizona,2,2,4,Two men were killed and two wounded in the desert near Tucson International Airport in the early morning.,2020
1144,2020-10-31,Anaheim,California,0,4,4,Four people were wounded in an early morning shooting at a strip club. The shooter pulled up outside the club and opened fire.,2020
1145,2020-10-31,Las Vegas,Nevada,0,4,4,"Four people were shot in a neighborhood, at a believed house party after a dispute escalated. The wounded are believed to be teenagers.",2020
1146,2020-10-31,College Park,Maryl,0,7,7,Seven people were wounded at a party held in a hotel room at the University of Maryland.,2020
1147,2020-10-31,Sacramento,California,0,4,4,Four people were wounded in a drive-by shooting in the Natomas area. Those wounded had gathered at a home there.,2020
1148,2020-10-31,Sumner,Washington,0,5,5,"Five people were wounded after an argument escalated outside of a house party, shortly after midnight.",2020
1149,2020-10-30,Waldorf,Maryl,1,3,4,Two groups of men got into a dispute inside a cigar and hookah lounge and the argument escalated. One man was killed and three injured.,2020
1150,2020-10-30,Chicago,Illinois,1,3,4,A man was killed and two adults and a sixteen-year-old were injured after a man entered a home in Morgan Park and opened fire. Police believe the shooting was drug related.,2020
1151,2020-10-29,Winter Garden,Florida,0,4,4,"A patrol officer discovered four people wounded after an argument escalated late at night. One of the victims has a concealed weapons permit, but officers are unsure who actually fired.",2020
1152,2020-10-28,Roanoke,Virginia,0,4,4,Officers responded to a report of multiple shots fired and found four individuals wounded in a home.,2020
1153,2020-10-28,Newark,New Jersey,1,3,4,One individual was killed and three others wounded after a heated argument escalated.,2020
1154,2020-10-26,Bessemer,Alabama,1,3,4,An eighteen-year-old was killed and three other teens were wounded in a house during the evening.,2020
1155,2020-10-25,San Antonio,Texas,0,4,4,A dispute potentially near I-35 escalated and four people within a car were shot. The car crashed a short time later. Three adults and a thirteen-year-old were wounded and three additional children were not injured.,2020
1156,2020-10-25,Raleigh,North Carolina,1,3,4,Four men were shot in the early morning. Two men were later arrested for the shooting and a wounded man died later at the hospital.,2020
1157,2020-10-25,Fort Worth,Texas,2,3,5,A fight broke out at an early morning house party and escalated. Two men were killed and three others wounded.,2020
1158,2020-10-24,Greenwood,Mississippi,2,8,10,A gunman walked into a family's front yard and opened fire on a family gathering shortly before midnight. The family had gathered for a funeral and two were killed and eight wounded.,2020
1159,2020-10-22,Rayne,Louisiana,0,5,5,A vehicle with six passengers – two adults and four juveniles – was traveling on I-10 when a car next to them opened fire. Five people in the car were wounded.,2020
1160,2020-10-22,Miami,Florida,1,3,4,Shortly before midnight someone opened fire in a Miami neighborhood. A man was killed and two adults and an infant girl were wounded.,2020
1161,2020-10-22,Boston,Massachusetts,0,4,4,Officers responded to a gunfire locator alert and multiple 911 calls and found two individuals wounded. An additional two transported themselves to the hospital.,2020
1162,2020-10-22,Baltimore,Maryl,0,4,4,Three men and a woman were wounded in a shooting shortly after midnight.,2020
1163,2020-10-21,New York City,New York,1,5,6,A man was killed and five other people were wounded in a drive-by shooting in Prospect Lefferts Gardens in Brooklyn.,2020
1164,2020-10-21,Canton,Mississippi,1,3,4,A gunman ambushed four people waiting in a car at a McDonald's drive through. One person in the car was killed and two adults and a thirteen-year-old were injured.,2020
1165,2020-10-20,Houston,Texas,3,1,4,An argument at a local open-mike night for rappers at a club escalated when at least two people opened fire. Three men were killed and one injured.,2020
1166,2020-10-19,Mansfield,Ohio,0,5,5,Five people were wounded in a drive-by-shooting while standing outside a house during a party. A seventeen-year-old and four adults were among the injured.,2020
1167,2020-10-19,New Orleans,Louisiana,1,3,4,A man was killed and three others wounded after gunfire erupted in front of a convenience store.,2020
1168,2020-10-18,Nashville,Tennessee,0,4,4,"Two men were discovered wounded at a home near Belmont University, and two others arrived at local hospitals later.",2020
1169,2020-10-18,Annapolis,Maryl,1,3,4,An argument at an early morning house party escalated and one man was killed. Another adult and two seventeen-year-old girls were wounded.,2020
1170,2020-10-18,Chicago,Illinois,1,4,5,A gunman walked into an East Garfield Park home and opened fire. He killed one man and wounded four others.,2020
1171,2020-10-17,Rock Hill,South Carolina,0,5,5,"A patrol officer heard gunfire near a local lounge in the early morning, and found a wounded man. Four others were transported by private vehicles to local hospitals.",2020
1172,2020-10-17,Lockport,New York,1,5,6,Shortly after midnight two men approached a home hosting a Halloween themed house party opened fire on the closed garage door. A 21-year-old college student was killed and five others were wounded.,2020
1173,2020-10-16,Mesa,Arizona,1,6,7,Six people were injured in a drive-by shooting and one was killed. Three of the injured were children and three were adults. The victim killed was one year old.,2020
1174,2020-10-16,San Francisco,California,1,3,4,A man was killed and another and two women were injured in an evening shooting.,2020
1175,2020-10-16,Orlando,Florida,3,1,4,Three people were killed and one wounded after an argument occurred in the early morning at a private motorcycle club over a motorcycle. The wounded victim is refusing to cooperate with police.,2020
1176,2020-10-16,San Jose,California,2,4,6,Shortly before midnight two men were killed and four injured at a local restaurant.,2020
1177,2020-10-15,Lafayette,Louisiana,2,2,4,A party after a University of Louisiana football game in Moore Park led to an early morning shooting after an argument escalated. Two people were wounded and two killed.,2020
1178,2020-10-15,Baltimore,Maryl,0,7,7,Seven people were wounded in an evening shooting in Southwest Baltimore. Two people were discovered at the scene and five were later discovered at area hospitals.,2020
1179,2020-10-14,Philadelphia,Pennsylvania,0,4,4,Four men were injured at a gas station in an evening shooting in Southwest Philadelphia.,2020
1180,2020-10-12,Myrtle Beach,South Carolina,2,3,5,A man was killed and four others were injured at a local grocery store early in the morning. One of the injured died three days later.,2020
1181,2020-10-11,Atlanta,Georgia,0,4,4,Four people were wounded in an evening shooting at a downtown hotel. Additional guns and pills were discovered at the scene of the shooting.,2020
1182,2020-10-10,Chicago,Illinois,1,3,4,Four people were inside a vehicle when they were hit by gunfire near the West Garfield Park on the West Side. A man died and two adults and a seventeen-year-old girl were wounded.,2020
1183,2020-10-10,Kingstree,South Carolina,0,8,8,A man opened fire after he was ejected from a nightclub by firing into the club while standing in the road. Three people were discovered in the club and five were taken to the hospital in private vehicles.,2020
1184,2020-10-10,Jennings,Missouri,2,2,4,A woman and her six-year-old daughter were killed and her other daughters aged sixteen and ten-years-old were wounded. The woman's boyfriend was arrested as a person of interest.,2020
1185,2020-10-08,Philadelphia,Pennsylvania,1,6,7,At least two gunmen opened fire on a group of people in the city's Frankford neighborhood. One man was killed and six others wounded.,2020
1186,2020-10-07,Anchorage,Alaska,1,4,5,A man was killed and one man and three women were injured in an early morning shooting at a house party. Two teenagers were arrested and charged for the shooting.,2020
1187,2020-10-07,New York City,New York,1,3,4,One man was killed and three injured in an evening shooting at a Brooklyn building. Neighbors claim that the building was a local gambling den.,2020
1188,2020-10-05,Washington D.C.,Washington D.C.,0,4,4,"Two men and two women were shot in an evening shooting, with one victim in critical condition.",2020
1189,2020-10-04,Atlanta,Georgia,1,5,6,"A fight broke out between two women inside a store and shortly after three men arrived with guns and entered the store. The men opened fire, and customers returned fire, with one man killed and three adults and two juveniles injured.",2020
1190,2020-10-04,Indianapolis,Indiana,3,4,7,Police responding to reports of an early morning shooting found three men dead outside an establishment. Four additional wounded were identified at the hospital after transporting themselves.,2020
1191,2020-10-03,Sacramento,California,1,3,4,A nine-year-old girl was killed and two adults and a six-year-old girl were wounded at a Del Paso Heights park. They were part of a family gathering when a gunman drove up and opened fire.,2020
1192,2020-10-03,Clarksville,Tennessee,0,5,5,At least five people were wounded in an early morning shooting at a house party. An argument had broken out and escalated into gun fire.,2020
1193,2020-10-02,Seattle,Washington,0,4,4,A seventeen-year-old girl and three others were wounded in an evening shooting in Rainier Valley.,2020
1194,2020-10-02,New Orleans,Louisiana,0,4,4,Four people were wounded in a shooting in the Central Business District. Victims ran away from the original scene causing officers to believe there were more shootings than actual.,2020
1195,2020-10-01,Detroit,Michigan,0,5,5,Two women and three men were wounded in a shooting shortly before midnight in a rental hall.,2020
1196,2020-09-30,Milwaukee,Wisconsin,0,7,7,Seven people were shot at a funeral home.,2020
1197,2020-09-30,Jacksonville,Florida,0,4,4,Two men and two women were wounded inside an apartment with no signs of a break-in.,2020
1198,2020-09-30,Greensboro,North Carolina,0,4,4,Four North Carolina A&T State University students were wounded in an off-campus apartment complex.,2020
1199,2020-09-29,Plainsville,Ohio,2,2,4,Two men were killed and two wounded in an afternoon shooting. The men were recording a music video and got into an argument with another group which escalated.,2020
1200,2020-09-29,Philadelphia,Pennsylvania,0,5,5,Five men were wounded shortly before midnight while standing on a porch in the Logan section of the city.,2020
1201,2020-09-28,Detroit,Michigan,0,6,6,Four men and two women were injured in an early morning shooting after a large crowd had congregated outside a Gentleman's club in the city's southwest side.,2020
1202,2020-09-27,Nashville,Tennessee,0,4,4,"Four people were wounded near an intersection in the afternoon after an argument escalated. The gunman walked away to his vehicle, retrieved a pistol, opened fire, and drove away.",2020
1203,2020-09-27,Sandusky,Ohio,0,4,4,"A man shot and wounded four people shortly before midnight, with one victim discovered in a vehicle by police.",2020
1204,2020-09-27,San Bernardino,California,1,3,4,A nineteen-year-old was killed and three others injured in an evening shooting.,2020
1205,2020-09-26,Enterprise,Alabama,1,3,4,One man died and three others injured after someone opened fire on an early morning party in an apartment complex parking lot.,2020
1206,2020-09-26,Philadelphia,Pennsylvania,0,4,4,"Two teens, aged fifteen and sixteen-years-old and two adults were wounded just before midnight at a block party in West Philadelphia. The teens and one adult had been leaving the party when the gunman opened fire.",2020
1207,2020-09-26,Chicago,Illinois,0,4,4,Two men and two women were injured in an early morning drive-by shooting in Marquette Park on the Southwest Side.,2020
1208,2020-09-26,Waterloo,Iowa,2,6,8,Two people were killed and six injured in a shooting at a motorcycle club where over 100 people had gathered. Four others suffered injuries from broken glass and debris while fleeing from the gunfire.,2020
1209,2020-09-25,Philadelphia,Pennsylvania,0,4,4,Four teenagers aged between seventeen and nineteen-years-old were injured in a late night shooting in the Frankford section of the city.,2020
1210,2020-09-23,Hampton,Georgia,1,3,4,A woman was killed and her mother and young child were injured when a man entered the home and shot. He shot and injured an additional woman while carjacking her in an attempt to flee.,2020
1211,2020-09-23,Minneapolis,Minnesota,0,5,5,Three men and two women were injured outside a bar early in the morning after an argument escalated. The bar was the scene of another mass shooting in June were a man died and six were injured.,2020
1212,2020-09-21,Struthers,Ohio,1,4,5,"A man barged into a home in the early morning and opened fire, wounding four adults and killing a four-year-old child. The child reportedly was held by his mother when the man opened fire and was struck and killed in her arms.",2020
1213,2020-09-20,New York City,New York,0,4,4,Two women were discovered wounded in front of a house in Queens by police. Two men arrived at the hospital by private vehicles at a later time.,2020
1214,2020-09-20,Stamford,Connecticut,1,3,4,A woman was killed and three others injured in a housing complex parking lot shortly after midnight. A large crowd had gathered and someone opened fire.,2020
1215,2020-09-19,Plainfield,New Jersey,0,4,4,Police officers responded to a shooting after a ShotShopper alert and found four people wounded.,2020
1216,2020-09-19,West Memphis,Arkansas,0,5,5,Five people were shot in an evening shooting.,2020
1217,2020-09-19,Chicago,Illinois,0,4,4,"Four people were wounded in West Pullman less than an hour after the shooting in West Englewood. Two sedans pulled up to a group outside and opened fire towards people on the sidewalk, home porch and inside the home.",2020
1218,2020-09-19,Buffalo,New York,1,4,5,A woman was killed and four other people were injured in an early morning shooting at a street party.,2020
1219,2020-09-19,Rochester,New York,2,14,16,Rochester shooting: Two people were killed and 14 others were injured in Rochester at a backyard party on Pennsylvania Avenue.,2020
1220,2020-09-19,Chicago,Illinois,0,4,4,Four men were wounded in West Englewood while standing outside when someone opened fire.,2020
1221,2020-09-18,Little Rock,Arkansas,0,4,4,"Four people were wounded in a drive-by afternoon shooting, near I-630.",2020
1222,2020-09-16,Philadelphia,Pennsylvania,2,3,5,"Two men were killed and three wounded while playing basketball at the Roberto Clemente Playground in Spring Garden. Police believe the men were targeted as the three shooters chased them down, after the first confrontation.",2020
1223,2020-09-15,Chicago,Illinois,0,5,5,"Five people, including three teenagers, were wounded in a drive by shooting. The group were outside celebrating Mexican Independence.",2020
1224,2020-09-15,San Jose,California,2,3,5,Two people were killed and three others injured in a quintuple shooting near San Jose State University.,2020
1225,2020-09-14,Baker,Louisiana,0,4,4,"Three people were wounded in a vehicle and a fourth while walking down the street, after a drug deal turned into a robbery. One of the wounded was an eight-year-old girl.",2020
1226,2020-09-14,New Brunswick,New Jersey,2,6,8,Two people died and six others were injured in an overnight shooting near Rutgers University.,2020
1227,2020-09-13,Chicago,Illinois,1,3,4,"A man was killed and two adults and a seventeen-year-old boy were wounded while sitting on a homes porch in Englewood, after two men exited a vehicle and opened fire.",2020
1228,2020-09-13,Grand Rapids,Michigan,0,7,7,Seven people were wounded in a late night shooting outside a business in the city's southeast side. One victim's injuries were considered life-threatening.,2020
1229,2020-09-13,Manchester,Tennessee,3,3,6,"A man opened fire inside a vehicle on I-24 and killed one person in his vehicle and wounded another. He attempted to carjack three vehicles and wounded two people, before taking two hostages. At the end of the hostage taking a hostage and the gunman were dead and the other hostage released.",2020
1230,2020-09-13,Tampa,Florida,0,4,4,A security guard and three club goers were wounded after an individual opened fire from a car shortly after midnight.,2020
1231,2020-09-12,Chicago,Illinois,2,4,6,A man opened fire at an early morning house party after an argument escalated in the Austin neighborhood. Another individual returned fire causing the first shooter and three others to be wounded and two others killed.,2020
1232,2020-09-12,Wilson,North Carolina,0,5,5,Four adults and a teenager were wounded after a verbal altercation at a house party escalated.,2020
1233,2020-09-11,Donaldson,Louisiana,0,5,5,"Five people were wounded at a large party, with one aged sixteen-years-old.",2020
1234,2020-09-10,New Orleans,Louisiana,3,1,4,"Four minutes after a shooting, police were alerted to a second in which three men died, and one wounded.",2020
1235,2020-09-09,St. Louis,Missouri,1,3,4,A man was killed and three others wounded in the Wellston neighborhood.,2020
1236,2020-09-08,Baltimore,Maryl,0,5,5,Five people including a seventeen-year-old were injured while playing a dice game when a vehicle pulled up and opened fire.,2020
1237,2020-09-07,Aguanga,California,7,0,7,A shooting at a large marijuana grow house left seven people dead.,2020
1238,2020-09-07,Indianapolis,Indiana,1,4,5,An eighteen-year-old was killed and four others injured after a fight broke out during a party in the Butler-Tarkington neighborhood over a broken table.,2020
1239,2020-09-07,New Orleans,Louisiana,0,4,4,Four people including a fourteen-year-old boy were injured in Central City.,2020
1240,2020-09-07,New York City,New York,0,5,5,"A fifteen-year-old shooter opened fire at a group of people in a drive-by shooting, including a six-year-old in Brooklyn. Police believe the shooting to be gang related.",2020
1241,2020-09-07,Chicago,Illinois,1,3,4,An eight-year-old girl was killed and three others injured when another vehicle opened fire on them while they were sitting in another car in the Canaryville neighborhood.,2020
1242,2020-09-06,New Iberia,Louisiana,0,5,5,"Five people were wounded at a night club, and separate charges were filed against the club owner for operating during COVID-19 restrictions.",2020
1243,2020-09-06,Chicago,Illinois,0,4,4,Four people were wounded in the South Shore neighborhood in a drive-by shooting. Three adults and a seventeen-year-old were injured.,2020
1244,2020-09-06,Commerce City,Colorado,0,4,4,Four people were wounded at a large house party after a fight broke out in the early morning.,2020
1245,2020-09-06,Memphis,Tennessee,0,4,4,Two people opened fire in an apartment and wounded three adults and a five-year-old child.,2020
1246,2020-09-06,Baltimore,Maryl,0,4,4,Responding officers found a wounded man and three other wounded individuals transported themselves to the hospital.,2020
1247,2020-09-06,Kansas City,Missouri,0,6,6,Six people were wounded in Swope Park where a large crowd had gathered to watch cars do burnouts and donuts.,2020
1248,2020-09-06,St. Louis,Missouri,1,3,4,One woman was killed and three others injured in the Hamilton Heights neighborhood.,2020
1249,2020-09-06,Sparta,Georgia,1,6,7,Responding officers found a man dead and two wounded at an early morning birthday party. Four other wounded were identified at the hospital.,2020
1250,2020-09-05,Williston,Florida,0,6,6,"Six people were wounded in an early morning shooting at a block party/protest that was organized by a man to protest ""inequitable narratives.""",2020
1251,2020-09-05,Baltimore,Maryl,1,3,4,"Two men were discovered wounded by responding officers, one of whom later died at the hospital. Two more wounded were identified after transporting themselves to the hospital.",2020
1252,2020-09-05,Little Rock,Arkansas,0,4,4,"A man was found wounded at the River Market district, with witnesses stating the shooter opened fire after pulling a gun from his fanny pack. Three children aged, seventeen, sixteen and twelve-years-old were also wounded.",2020
1253,2020-09-05,Houston,Texas,0,4,4,"A woman and three men were wounded after a party with multiple motorcycle clubs, had a large fight in the parking lot with multiple shooters.",2020
1254,2020-09-03,Little Rock,Arkansas,0,4,4,"Two bystanders including a seventeen-year-old were wounded shortly before midnight at an apartment complex. Two additional wounded were discovered later by police, who stated the shooting occurred after the individuals they had met to purchase guns from, turned on them and opened fire.",2020
1255,2020-09-03,Hensley,Arkansas,1,3,4,"A nineteen-year-old was killed and two nineteen-year-old and an eighteen-year-old were injured, when a car pulled up alongside their vehicle and opened fire on I-530.",2020
1256,2020-09-03,Philadelphia,Pennsylvania,0,6,6,Five men aged eighteen to twenty-six-years-old were found wounded in an east Germantown street shortly before midnight. A sixth man was found wounded in his apartment building from a stray bullet a half-block away.,2020
1257,2020-09-03,Miami,Florida,0,4,4,Four men were wounded in a drive-by shooting shortly before midnight.,2020
1258,2020-09-02,Oakland,California,0,4,4,"Three teenagers, two fifteen-year-olds and a seventeen-year-old, and an adult were wounded in the Brookfield Village neighborhood in East Oakland. Police believe it to be a targeted shooting.",2020
1259,2020-09-02,Albany,Georgia,1,3,4,One man was killed and two other adults and a sixteen-year-old were wounded while playing cards in an early morning drive-by shooting.,2020
1260,2020-09-02,Philadelphia,Pennsylvania,2,2,4,Two seventeen-year-olds were killed and a seventeen and eighteen year old wounded in a shooting in Point Breeze.,2020
1261,2020-08-31,Tallahassee,Florida,0,4,4,"Police responding to a call of several people shot, found two adults and two teenagers aged thirteen and seventeen-years-old wounded in a townhouse complex.",2020
1262,2020-08-30,Lexington,Kentucky,0,7,7,Seven people were wounded at a community gathering at a local community center. Eyewitnesses were split on how the shooting occurred.,2020
1263,2020-08-30,Chicago,Illinois,1,4,5,"Five people were shot, one fatally, at a restaurant in Morgan Park.",2020
1264,2020-08-30,Zion,Illinois,0,4,4,A drive by shooting injured three adults standing outside early in the morning. An eight-year-old boy was injured when a bullet entered his bedroom through a wall.,2020
1265,2020-08-30,Madisonville,Kentucky,0,5,5,Four adults and a fourteen-year-old girl were injured at a block party when an unknown individual opened fire early in the morning.,2020
1266,2020-08-30,San Antonio,Texas,2,2,4,"A nineteen and seventeen-year-old were killed and two other teenagers were wounded, when a vehicle pulled up to the car that they were in and opened fire. Officers believe at least one person in the vehicle was the intended target.",2020
1267,2020-08-30,Buffalo,New York,1,4,5,"Five people were wounded in an early morning shooting, with one later dying at a hospital.",2020
1268,2020-08-29,Rock Island,Illinois,1,5,6,A man was killed and five others injured in an early morning shooting near a local pub.,2020
1269,2020-08-29,Las Vegas,Nevada,2,2,4,"Shortly before midnight a group was walking down an alley toward a store, when they were approached by three men. One opened fire and killed two of the group and injured two others.",2020
1270,2020-08-28,Dallas,Texas,0,5,5,Four adults and a fifteen-year-old boy were wounded in a late night shooting in the Deep Ellum district.,2020
1271,2020-08-28,Minneapolis,Minnesota,0,4,4,Four men were wounded by multiple shooters who fled the scene in the car they shot from.,2020
1272,2020-08-27,Portland,Oregon,1,3,4,A sixteen-year-old boy was killed and three other juveniles were wounded in Gateway Discovery Park.,2020
1273,2020-08-26,Pontiac,Michigan,3,1,4,"A man engaged in a year-long dispute with neighbors, shot four of them as they sat on his porch. Three died and one was wounded, with the shooter later turning himself in.",2020
1274,2020-08-26,Hilton Head Island,South Carolina,0,4,4,"Three men and a woman were injured in a late night shooting, while in a large gathering.",2020
1275,2020-08-26,Philadelphia,Pennsylvania,0,4,4,Three adults and a seventeen-year-old boy were injured in East Germantown in an evening shooting.,2020
1276,2020-08-25,Rochester,New York,0,4,4,"Four men were wounded in an evening shooting, with two being transported to the hospital in private vehicles.",2020
1277,2020-08-25,Norfolk,Virginia,0,5,5,Norfolk police said five people were shot on Wednesday night. One of the victims was a 1-month-old child. No suspect information is available at this time.,2020
1278,2020-08-24,West Palm Beach,Florida,0,4,4,Four people were wounded in an evening shooting.,2020
1279,2020-08-24,Richmond,Virginia,1,4,5,A man was killed and four others including a teenage boy were wounded in a night shooting.,2020
1280,2020-08-24,Sacramento,California,1,3,4,"A man was killed and three others wounded, in an early morning shooting.",2020
1281,2020-08-24,Detroit,Michigan,0,4,4,"Four men were wounded after a vehicle pulled up and opened fire, with one of the wounded returning fire.",2020
1282,2020-08-23,Champaign,Illinois,0,4,4,Four men were wounded at a party outside an apartment complex when a fight escalated early in the morning.,2020
1283,2020-08-23,Chicago,Illinois,0,4,4,"Four men were wounded standing outside a business in the Englewood neighborhood, in an afternoon drive-by shooting.",2020
1284,2020-08-23,Pueblo,Colorado,0,6,6,Early in the morning responding officers found three wounded individuals at a home near Pikes Peak International Raceway. Three more wounded were identified at a local hospital and some of the wounded are teenagers. Officers believe the shooting happened at a house party.,2020
1285,2020-08-23,Somerville,Tennessee,1,4,5,A nineteen-year-old man was killed and two men and two women injured in an early morning shooting at a party.,2020
1286,2020-08-23,New York City,New York,1,3,4,A man was killed and three others wounded in a housing complex in Brooklyn in the early morning.,2020
1287,2020-08-23,Pine Bluff,Arkansas,0,7,7,Seven people were wounded when gunfire erupted while a large crowd was gathered outside a gas station early in the morning.,2020
1288,2020-08-22,Hueytown,Alabama,1,3,4,One person was killed and three wounded after an early morning shooting near the Allison Bonnet Memorial Drive.,2020
1289,2020-08-22,Rockford,Illinois,1,3,4,Shortly before midnight one man was killed and three others injured.,2020
1290,2020-08-19,Chicago,Illinois,0,6,6,Five adults and a seventeen-year-old were wounded after a man stepped out of a vehicle and opened fire on a large gathering. The shooting took place in Gresham in the South Side.,2020
1291,2020-08-19,Philadelphia,Pennsylvania,0,4,4,A gun fight wounded two adults and two seventeen-year-olds in West Philadelphia.,2020
1292,2020-08-18,Philadelphia,Pennsylvania,1,4,5,A man was killed and four others wounded including a fifteen-year-old in the Strawberry Mansion neighborhood.,2020
1293,2020-08-18,New York City,New York,0,4,4,A car drove up to a Ravenswood Public Housing building in Queens and opened fire. A seventeen-year-old boy and three adults were wounded.,2020
1294,2020-08-18,Rockford,Illinois,0,4,4,Four people were wounded in the early morning at a large gathering in Twin Sisters Park.,2020
1295,2020-08-17,Dayton,Texas,3,2,5,"A man is accused of killing his ex-girlfriend, a man in her home, and a neighbor and wounding two others. He was later arrested after hiding in the surrounding woods.",2020
1296,2020-08-17,New York City,New York,0,4,4,Four men were wounded in an early morning shooting in Brooklyn. The suspected gunman fled in a car after opening fire.,2020
1297,2020-08-17,Cleveland,Ohio,0,5,5,Five people were wounded at Dove Park in an evening drive-by shooting.,2020
1298,2020-08-17,Louisville,Kentucky,2,2,4,Two people were killed and two people were wounded in a shooting late at night before the car they were in crashed.,2020
1299,2020-08-16,Lexington,Kentucky,1,3,4,An eighteen-year-old was killed and three others wounded after a disturbance occurred at a large gathering.,2020
1300,2020-08-16,San Antonio,Texas,0,5,5,"Five people were injured, one critically, in a shooting caused by a dispute at a flea market. A security guard returned fire.",2020
1301,2020-08-16,Cincinnati,Ohio,2,9,11,One person died at the scene and one later at the hospital with nine others wounded in an early morning shooting.,2020
1302,2020-08-16,Denver,Colorado,2,5,7,Two men were killed and five others were wounded in a shooting shortly after an earlier shooting.,2020
1303,2020-08-16,Cincinnati,Ohio,1,3,4,"Responding officers found a man wounded shortly after midnight, who later died at the hospital. Three others arrived by private vehicles to the hospital.",2020
1304,2020-08-16,Oklahoma City,Oklahoma,0,4,4,Four people were wounded at a large birthday party in the parking lot.,2020
1305,2020-08-15,Troy,Alabama,2,3,5,Officers arrived at a large gathering early in the morning to disperse it. While doing so shots were fired in the apartment complex's parking lot. Two men were killed and three others wounded.,2020
1306,2020-08-15,New Haven,Connecticut,1,5,6,One man was killed and five injured after a dice game grew violent shortly before midnight.,2020
1307,2020-08-15,Belleville,Michigan,4,0,4,"Two men and two women were killed in a home, with one of the women killed identified as the shooter's former fiancée. The shooter boasted about the killings on social media and text messages before being arrested.",2020
1308,2020-08-15,Rochester,New York,0,5,5,Five people were wounded shortly before midnight.,2020
1309,2020-08-15,Philadelphia,Pennsylvania,0,5,5,Four adults and a sixteen-year-old boy were injured shortly before midnight at a large block party when a group on motorcycles arrived and opened fire.,2020
1310,2020-08-14,New York City,New York,0,4,4,Three women and one man were wounded late at night on Lenox Avenue in Harlem.,2020
1311,2020-08-12,Dayton,Ohio,1,3,4,A woman was killed and three others wounded in a drive by shooting in the early morning.,2020
1312,2020-08-12,Newark,New Jersey,1,4,5,An eighteen-year-old was killed and four others wounded shortly after midnight.,2020
1313,2020-08-11,Los Angeles,California,0,5,5,"Five people were wounded shortly after midnight outside of a warehouse in the Harbor Gateway neighborhood. The shooting occurred after an argument escalated, and an additional person was injured attempting to climb a fence.",2020
1314,2020-08-09,Houston,Texas,0,4,4,"Four men were wounded being a gas station shortly before midnight. The men were playing dice, when a gunman walked up, shot them and fled on foot.",2020
1315,2020-08-09,Jackson,Mississippi,0,4,4,"Four people were wounded in the evening, two of the victims drove away and later crashed outside a local bank.",2020
1316,2020-08-09,Washington D.C.,Washington D.C.,1,21,22,"2020 Washington, D.C. block party shooting: A 17-year-old boy was killed and 21 others injured, including an off-duty police officer, at a party in the southeastern section of the nation's capital. Police are looking for three suspects.",2020
1317,2020-08-09,Toledo,Ohio,0,6,6,Six people were wounded in the early morning after a large gathering turned violent near a shopping center.,2020
1318,2020-08-09,Denver,Colorado,0,10,10,Ten people were injured in a drive-by shooting during a family gathering in a park.,2020
1319,2020-08-08,Birmingham,Alabama,1,5,6,"A man was killed and five people, including an off-duty Birmingham Police officer, were wounded at a motorcycle club in Ensley. The shooting was reported to be due to an altercation escalating, with some of the victims innocent bystanders.",2020
1320,2020-08-08,Brockton,Massachusetts,0,5,5,Five men were wounded at a house party which was detected by the city's gunshot detection system. Prior a woman from the same party was stabbed.,2020
1321,2020-08-08,Philadelphia,Pennsylvania,0,6,6,"A pregnant woman, three teenagers and two other women were wounded. They were a part of a large BBQ gathering at a public park.",2020
1322,2020-08-08,Paducah,Kentucky,1,4,5,Shortly before midnight a man was killed and four others wounded in the city's north side.,2020
1323,2020-08-08,Albany,New York,1,3,4,"A 18-year-old man was killed and a 22-year-old, 28-year-old, and 29-year-old were injured in a drive by shooting involving multiple suspected perpetrators.",2020
1324,2020-08-06,Oakland,California,1,3,4,A man was killed and three others injured while standing outside a house party.,2020
1325,2020-08-05,Chicago,Illinois,0,4,4,An 8-year-old boy and three men were wounded in the North Lawndale neighborhood. The shooter exited a vehicle and opened fire on the group while they were standing on the sidewalk.,2020
1326,2020-08-04,Washington D.C.,Washington D.C.,0,4,4,Four men were wounded in an evening shooting.,2020
1327,2020-08-04,Madison,Wisconsin,0,4,4,Four people were wounded in Garner Park during a memorial service for a recently deceased individual. Over 300 people were gathered when gunfire broke out and a fifth person was injured fleeing.,2020
1328,2020-08-04,Los Angeles,California,1,4,5,A woman was killed and four others were injured at a rented mansion house party. The home was on the famed Mulholland Drive in the Beverly Crest neighborhood.,2020
1329,2020-08-04,St. Louis,Missouri,1,3,4,A woman was killed and two adults and a 17-year-old were injured near the former ABB manufacturing plant. The plant was the scene of a mass shooting in 2010.,2020
1330,2020-08-04,Hartford,Connecticut,1,5,6,A man was killed and five others injured after an early morning shooting at a large gathering at a warehouse.,2020
1331,2020-08-03,New York City,New York,0,4,4,Four people were wounded after a shooter opened fire on a large crowd watching a basketball game at St. Mary's Park in the Bronx.,2020
1332,2020-08-02,Newark,New Jersey,0,5,5,Four adults and a 10-year-old child were wounded after multiple heavily armed shooters opened fire on males in a specific block.,2020
1333,2020-08-02,Philadelphia,Pennsylvania,0,4,4,Four women were injured with gun fire in the early morning. A fifth woman was stabbed multiple times.,2020
1334,2020-08-01,Montgomery,Alabama,0,4,4,Four men were injured after a shooting at an entrance to I-85 South.,2020
1335,2020-08-01,Denver,Colorado,1,4,5,A 16-year-old was killed and three adults and a girl were wounded at a large gathering in the Westwood neighborhood.,2020
1336,2020-08-01,Pointblank,Texas,2,3,5,Two men were killed and two adults and an infant were injured. A man entered a home where a child's birthday party was ongoing and opened fire. Two guests returned fire and were among the injured.,2020
1337,2020-08-01,Chicago,Illinois,1,4,5,"A man was killed and four others, two men and two women, were injured at a backyard BBQ. Responding officers arrested two men fleeing from the scene.",2020
1338,2020-07-31,Philadelphia,Pennsylvania,1,3,4,A woman was killed and three men were wounded in an evening shooting.,2020
1339,2020-07-30,Miami Gardens,Florida,0,5,5,Five men were wounded after a potentially gang related shooting occurred behind a U-Gas Station. A witness likened the amount of gunfire to the Iraq war.,2020
1340,2020-07-30,Tampa,Florida,0,5,5,A man opened fire at a gas station while screaming at passersby. He wounded five people before he was arrested.,2020
1341,2020-07-29,Detroit,Michigan,0,4,4,Three men and a woman were injured while standing outside and a person opened fire from a car.,2020
1342,2020-07-29,Elyria,Ohio,5,0,5,"A man killed his wife and three children, aged 12, 10 and 6-years-old, and then himself in an apparent murder-suicide.",2020
1343,2020-07-29,St. Louis,Missouri,3,1,4,Three men were killed and a third injured after an afternoon dispute escalated between two groups of people.,2020
1344,2020-07-28,Milwaukee,Wisconsin,0,4,4,Four men were injured in the evening.,2020
1345,2020-07-28,Wilmington,Delaware,2,2,4,A 17-year-old and a woman were killed and two men were injured in a shooting.,2020
1346,2020-07-27,Chicago,Illinois,1,4,5,Five people were sitting on a porch in the evening when one was killed and four injured in a drive-by shooting.,2020
1347,2020-07-27,Federal Way,Washington,1,3,4,A 17-year-old was killed and two adults and a 12-year-old injured at Steel Lake Park. A woman reportedly opened fire after an argument.,2020
1348,2020-07-26,Magnolia,Arkansas,0,4,4,Four people were injured in the early morning after at least two semi-automatic handguns were fired at a large house party.,2020
1349,2020-07-26,Mont Enterprise,Texas,0,4,4,Four people were injured shortly after midnight when someone opened fire during the Rude Boyz Annual Trail Ride. The gathering was held at Durango's Canyon.,2020
1350,2020-07-26,Flint Township,Michigan,1,3,4,"One person was killed and three others were injured when two men opened fire in a restaurant. One man was charged with open murder, three counts of assault with intent to murder and multiple weapons charges. The other man was charged with careless discharge of a firearm.",2020
1351,2020-07-26,Commerce City,Colorado,1,3,4,Responding officers to a large gathering in the early morning found a man dead. Three additional victims were transported in private vehicles to the hospital.,2020
1352,2020-07-26,Louisville,Kentucky,1,3,4,"Officers responded to I-64 West in the early morning after calls of shots fired by a moving vehicle. They found four individuals shot, with one dead, in a crashed car. A fifth individual was wounded when the car crashed.",2020
1353,2020-07-25,Manteca,California,0,7,7,Officers responded from a traffic stop after hearing gunfire. They discovered seven people wounded at a large house party after a man armed with a semi-automatic weapon arrived and opened fire.,2020
1354,2020-07-25,Miami,Florida,1,3,4,"A seven-year-old girl, a sixteen-month boy and two adults were shot by a passing vehicle while getting out of a car. The girl was declared brain dead at the hospital, causing the shooting to be declared a homicide.",2020
1355,2020-07-25,Dallas,Texas,0,4,4,"Three men and a woman were injured shortly before midnight. A man was denied entry at a local bar, retrieved an assault-type weapon from his car, and shot into the building.",2020
1356,2020-07-25,Denver,Colorado,2,3,5,Two men were killed and two woman and a man were wounded in the Park Hill neighborhood.,2020
1357,2020-07-25,Flint,Michigan,0,6,6,"Six people were shot at a party of over 1,000 people following the filming of a music video in a parking lot.",2020
1358,2020-07-25,Raleigh,North Carolina,0,4,4,A woman and three men were wounded near a local restaurant.,2020
1359,2020-07-24,Atlanta,Georgia,2,2,4,"Two adults were killed and two teenagers, aged seventeen and eighteen, were injured in an early morning shooting. The group were ambushed by two shooters after arriving at an AirBnb house party in a rideshare.",2020
1360,2020-07-23,Henrico County,Virginia,1,3,4,One man was killed and three others injured in the early morning. Officers are investigating if the individuals were a part of an announced party for that night.,2020
1361,2020-07-23,Chicago,Illinois,2,4,6,Two people were killed and four injured while standing on the sidewalk in the West Pullman area of the Far South Side.,2020
1362,2020-07-23,Petersburg,Virginia,0,4,4,Four people were wounded in an early morning shooting.,2020
1363,2020-07-22,Warren,Michigan,0,4,4,A man opened fire and others returned fire at a large party with at least one hundred people in attendance. Four people were injured in the shooting.,2020
1364,2020-07-21,Chicago,Illinois,0,15,15,"Fifteen people were injured, four critically, after a shooter opened fire at people leaving a funeral home in Chicago's Auburn Gresham neighborhood.",2020
1365,2020-07-20,Richmond,Virginia,1,4,5,One man was killed and four others injured after a fight in a McDonald's parking lot escalated. One of the injured was an innocent bystander in the Food Lion parking lot across the street.,2020
1366,2020-07-20,Chicago,Illinois,0,5,5,Five people were wounded in the North Lawndale neighborhood. They were a part of people gathered on the sidewalk when a car pulled up and several men got out and opened fire.,2020
1367,2020-07-19,Detroit,Michigan,3,1,4,"A man opened fire in a restaurant, killing three men and injuring another. The shooter has been taken into custody.",2020
1368,2020-07-19,Chicago,Illinois,2,3,5,"Two people were killed and three wounded shortly before midnight in Morgan Park on the Far South Side. They were part of a group of people, that were fired upon by an unknown shooter.",2020
1369,2020-07-19,Detroit,Michigan,0,4,4,"Two fifteen-year-olds and two seventeen-year-olds were wounded while sitting in traffic when another car pulled up and opened fire. Four days later, the suspect was shot by police after a pursuit in which he was found holding a gun and died at a hospital.",2020
1370,2020-07-19,Washington D.C.,Washington D.C.,1,8,9,Police responding to reports of a shooting discovered one man killed and eight other adults wounded.,2020
1371,2020-07-19,Omaha,Nebraska,0,8,8,Eight people including a fifteen-year-old girl were injured in a drive by shooting early in the morning.,2020
1372,2020-07-19,Peoria,Illinois,0,13,13,Thirteen people were injured in an early morning shooting at a riverfront gathering. An argument between two women led to a man firing two shots into the air. This led to multiple individuals opening fire on the crowd.,2020
1373,2020-07-18,Chicago,Illinois,1,4,5,A man was killed and four others wounded after two men opened fire in the early morning in the North Lawndale neighborhood. The men were standing on a street corner.,2020
1374,2020-07-17,Columbus,Ohio,0,4,4,Four adults were wounded while attending a memorial in Weinland Park. A three-year-old girl was also wounded when bullets struck the home she was in.,2020
1375,2020-07-17,Madison,Florida,0,4,4,"Three adults and a child were injured after a man, out on bond from a January arrest, entered their home and opened fire.",2020
1376,2020-07-16,Nashville,Tennessee,0,5,5,"Eight or nine people opened fire in the early morning in a drive-by shooting. Five people were wounded, including a juvenile.",2020
1377,2020-07-15,Shreveport,Louisiana,1,3,4,A man was killed and two adults and an 11-year-old child were injured after an argument escalated from an original argument at a basketball court.,2020
1378,2020-07-15,New York City,New York,1,5,6,Two gunmen opened fire in the early morning outside a Brooklyn apartment building. A man was killed and five other adults were wounded.,2020
1379,2020-07-14,St. Joseph,Missouri,0,5,5,Five men were injured while standing in a park after a vehicle drove by and opened fire.,2020
1380,2020-07-14,Durham,North Carolina,0,8,8,Six adults and two children aged four and eight-years-old were wounded after someone opened fire at a party outside a home.,2020
1381,2020-07-13,Kent,Washington,0,6,6,Five adults and a teenager were wounded after an argument escalated at a Metro bus stop.,2020
1382,2020-07-13,Louisville,Kentucky,1,3,4,"A 16-year-old was killed and three others, including two juveniles, were wounded at a gas station.",2020
1383,2020-07-13,New York City,New York,0,6,6,Multiple shooters traveled across three different blocks and wounded six people in Brooklyn.,2020
1384,2020-07-12,Baton Rouge,Louisiana,1,7,8,A man was killed and seven others injured in an early morning shooting outside an Exxon gas station.,2020
1385,2020-07-12,Chicago,Illinois,1,4,5,Four men were wounded and one killed in an early morning shooting. The group was standing in the street when a verbal altercation escalated with at least two shooters.,2020
1386,2020-07-12,Chicago,Illinois,1,3,4,A man was killed and two other men and a woman were wounded in Englewood in the evening.,2020
1387,2020-07-12,Fort Lauderdale,Florida,2,2,4,"Two men were killed in an early morning shooting at a party, with two others wounded.",2020
1388,2020-07-12,New York City,New York,1,3,4,Two men opened fire on a late night cookout at the Raymond Bush Playground in Brooklyn. Three men were injured and an infant sitting in a stroller was killed.,2020
1389,2020-07-12,Lansing,Michigan,0,5,5,Three women and two men were injured after someone opened fire outside an apartment complex. At the complex there was a large party happening with over 100 people present.,2020
1390,2020-07-12,Como,Mississippi,2,3,5,"Two people were killed and three injured at a large outdoor hip hop concert in which potentially five separate guns were used. An additional three people were injured while attempting to flee, after being hit by cars.",2020
1391,2020-07-11,Wilmington,Delaware,0,5,5,Four teenagers aged between 15 and 13-years-old and 10-year-old child were wounded. Someone opened fire on a playground late at night.,2020
1392,2020-07-11,Rochester,New York,0,6,6,Responding officers to an early morning block party arrived to gunfire. Two wounded individuals were identified at the party and four others were identified at local hospitals.,2020
1393,2020-07-07,Paterson,New Jersey,4,3,7,"In a late night shooting, four people were killed and three injured. Officers suspect the shooting was retaliation by people recently released from prison.",2020
1394,2020-07-07,Alexandria,Virginia,0,5,5,Shortly after midnight an individual stormed an apartment and wounded a man and four teenagers aged 14 to 19-years-old.,2020
1395,2020-07-06,Chicago,Illinois,0,6,6,Shots were fired into a group of people in the Auburn Gresham area on the South Side. The evening shooting wounded six.,2020
1396,2020-07-05,Chicago,Illinois,1,5,6,A woman was killed and five men were wounded in an early morning drive-by shooting. The group was setting off fireworks when the car approached.,2020
1397,2020-07-05,Chicago,Illinois,0,4,4,A 16-year-old girl and three adults were wounded by gunfire while standing in an alley in the West Side's Fifth City neighborhood in the early morning.,2020
1398,2020-07-05,Houston,Texas,0,4,4,Three men waiting at a stop light and were wounded when someone opened fire. Comedian Rickey Smiley's daughter was a passenger in another vehicle and was also wounded.,2020
1399,2020-07-05,Detroit,Michigan,2,4,6,Two men were killed and four others - two men and two women - were injured in a shooting at a late-night party.,2020
1400,2020-07-05,Greenville,Mississippi,0,4,4,"A group of people were traveling in a party bus, when someone opened fire on the vehicle. Four people in the bus were wounded.",2020
1401,2020-07-05,Davenport,Iowa,1,3,4,Officers arrived at an early morning fight and heard shots being fired. They later discovered a man killed by the gunfire and three others injured.,2020
1402,2020-07-05,New York City,New York,0,5,5,"Four adults and a 15-year-old boy were injured in an early morning shooting in Inwood, Manhattan.",2020
1403,2020-07-05,Helena,Arkansas,1,3,4,"A man was killed and three others injured in a parking lot, after leaving an event held by rapper Bankroll Freddie. People were leaving the event when someone fired into the crowd.",2020
1404,2020-07-05,Milwaukee,Wisconsin,0,4,4,Shortly after midnight three men and one woman were injured.,2020
1405,2020-07-05,Greenville,South Carolina,2,8,10,"At least two people are killed and eight injured, four critically, at a nightclub. No suspects have been arrested.",2020
1406,2020-07-05,Atlanta,Georgia,2,12,14,"A large group of people were watching fireworks, when a fight broke out after a car hit a pedestrian. Fourteen people were wounded, of which two were declared dead at the hospital.",2020
1407,2020-07-05,Ephrata,Pennsylvania,0,4,4,A 20-year-old opened fire on a group of six people after getting into an altercation and taking a rifle from his father. Four of the group were injured and the 20-year-old and his father were arrested.,2020
1408,2020-07-05,Columbia,Missouri,2,3,5,"An adult and 11-year-old girl were killed shortly after midnight, three others were wounded. Officers believe that there were two shooters.",2020
1409,2020-07-05,Freeport,Illinois,1,5,6,Shortly after midnight a man was killed and five others were wounded.,2020
1410,2020-07-05,Barnwell County,South Carolina,0,5,5,Five teenagers were wounded shortly after midnight after a shooting occurred at a house party.,2020
1411,2020-07-05,Cambridge,Maryl,0,4,4,"Four people were wounded in an early morning shooting, with potentially multiple weapons used.",2020
1412,2020-07-04,Chicago,Illinois,1,3,4,A man was killed and three others injured in a late night shooting in South Chicago.,2020
1413,2020-07-04,Lynn,Massachusetts,1,4,5,A man was killed and four others injured at a July 4 cookout.,2020
1414,2020-07-04,Chicago,Illinois,4,4,8,"Four people are killed, and at least four more were injured at an outdoor gathering in Englewood when four men opened fire into a crowd. No suspects have been arrested.",2020
1415,2020-07-04,Atlanta,Georgia,0,5,5,"A group of people were fired at by an individual in a vehicle, shortly before midnight. Five people were wounded.",2020
1416,2020-07-04,Jackson,Mississippi,1,3,4,"An early morning shooting occurred at a nightclub, after an altercation escalated. One person was killed and three others wounded.",2020
1417,2020-07-04,Temple Hills,Maryl,1,3,4,"Four men were wounded in Marlow Heights, one man later died at the hospital.",2020
1418,2020-07-04,Baton Rouge,Louisiana,0,4,4,Two adults and two children were injured in a drive-by shooting.,2020
1419,2020-07-03,Baltimore,Maryl,0,4,4,Four women were injured in a late night shooting in southwest Baltimore.,2020
1420,2020-07-03,Hoover,Alabama,1,3,4,A suspected shootout occurred inside the Riverchase Galleria in the afternoon. An 8-year-old boy was killed and two adults and a girl were injured.,2020
1421,2020-07-02,Somerville,Massachusetts,0,4,4,"A man and three women were wounded in a late night shooting, the next day three suspects were arrested.",2020
1422,2020-07-02,Paterson,New Jersey,1,4,5,A man was killed and four others injured shortly after midnight on a street corner.,2020
1423,2020-07-02,Delano,California,2,3,5,A group of five were shot after a man got out of a vehicle and opened fire. Two girls were killed aged 11 and 12-years-old and three adults were wounded.,2020
1424,2020-07-01,Oakland,California,0,4,4,Three men and a woman were wounded in their vehicle on Interstate 580.,2020
1425,2020-06-30,Atlanta,Georgia,1,4,5,"Early in the morning, a group of men sitting on the sidewalk were shot at in a drive-by. One man was killed and four injured.",2020
1426,2020-06-30,Davenport,Iowa,0,5,5,Five men were wounded in an evening shooting. Officers believed the shooting was targeted at the group.,2020
1427,2020-06-30,Chicago,Illinois,0,4,4,Shortly after midnight three men and a woman were shot while waiting in a vehicle at a Shell gas station in River North neighborhood. The shooter was in and later fled in a red sedan.,2020
1428,2020-06-30,Dayton,Ohio,0,4,4,Three men and one women were all wounded in a shooting.,2020
1429,2020-06-30,Greenbrier,Arkansas,0,4,4,"Three adults and one juvenile were wounded, after going to a residence and getting into an altercation. The shooter was a juvenile resident of the home.",2020
1430,2020-06-30,Boston,Massachusetts,1,3,4,Officers responding to a call of shots fired discovered four wounded individuals. A man later died at the hospital.,2020
1431,2020-06-29,Los Angeles,California,0,4,4,Four men were wounded in a public park in Sylmar in a drive-by shooting.,2020
1432,2020-06-29,Sioux Falls,South Dakota,1,3,4,"A man shot and killed another man in a home, after mistaking it as the home of his intended target. He left and entered the correct home and wounded three others.",2020
1433,2020-06-28,Sawyerville,Alabama,0,7,7,"During an early morning field party, seven people were wounded after an argument between two men escalated.",2020
1434,2020-06-28,Philadelphia,Pennsylvania,2,2,4,Two men were killed and two injured in a late night shooting in the Kensington neighborhood.,2020
1435,2020-06-27,Red Bluff,California,2,4,6,Red Bluff shooting. An employee was killed and four injured at a Walmart distribution center. The perpetrator was later killed in a shootout with responding police.,2020
1436,2020-06-27,Roselle,Illinois,1,4,5,"During a party at a rented house, 4 people were wounded and one person was killed when one person began firing a handgun inside the home, and then several people began firing handguns inside the home. Police revealed that over 60 gunshots were fired at the scene.",2020
1437,2020-06-27,Peoria,Illinois,0,4,4,Officers responding to an early morning ShotSpotter alert found two men wounded and identified two women who arrived at the hospital to be a part of the incident.,2020
1438,2020-06-27,New York City,New York,0,4,4,"Early in the morning a man opened fire at a house party in Brooklyn, and injured four people.",2020
1439,2020-06-27,Chicago,Illinois,1,3,4,A man was killed and three others wounded after a large gathering in Douglas.,2020
1440,2020-06-27,Blytheville,Arkansas,3,1,4,"A Missouri man traveled to the area for a house party, where a couple got into a physical domestic fight. Shortly after 911 was called in response to that fight the man opened fire and killed his Uncle and two others, and wounded another.",2020
1441,2020-06-26,Aurora,Colorado,0,5,5,Five people were wounded by a shooter outside a local grocery store. Officers previously thought the incident was a gunfight but later announced it was one shooter.,2020
1442,2020-06-26,Fresno,California,0,4,4,"Four people were wounded at a house party shortly before midnight, after two shooters appeared near a neighboring home.",2020
1443,2020-06-26,Phoenix,Arizona,0,4,4,"Three adults and a 14-year-old boy were wounded in the early morning at a gas station. Prior to the shooting, a large crowd of people and cars had been gathered around the gas station.",2020
1444,2020-06-25,Philadelphia,Pennsylvania,0,4,4,Four men were wounded after a shooting at an intersection in the Kensington neighborhood.,2020
1445,2020-06-25,Bridgeport,Connecticut,1,3,4,"A man was killed, and two adults and a 17-year-old injured while attempting to make a rap music video. Officers believed the shooting was targeted, as the victims refused to cooperate.",2020
1446,2020-06-24,Jackson,Tennessee,0,4,4,Three adults and one juvenile were wounded in an early morning shooting. The suspected shooter was arrested.,2020
1447,2020-06-23,Chicago,Illinois,0,4,4,"Four people were wounded in a drive by shooting in Burnside, while standing on a porch.",2020
1448,2020-06-23,Lake Worth Beach,Florida,0,5,5,Five people were wounded in a drive-by shooting during the evening. Responding police believed the shooter and victims know each other.,2020
1449,2020-06-22,New York City,New York,0,5,5,Five people were shot during a vigil in the Crown Heights area of Brooklyn in the evening.,2020
1450,2020-06-22,Chicago,Illinois,0,4,4,Four people were wounded early in the morning after an individual opened fire from a vehicle in the Back of the Yards neighborhood on the South Side.,2020
1451,2020-06-22,Chicago,Illinois,0,5,5,"Five people were wounded in a drive-by, including a 16-year-old girl, at an early morning gathering in East Garfield Park.",2020
1452,2020-06-22,Minneapolis,Minnesota,0,4,4,Four people were wounded in the Willard-Hay neighborhood during the afternoon.,2020
1453,2020-06-22,Charlotte,North Carolina,3,6,9,"Officers responding to a block party on reports of someone being hit by a car arrived to shots being fired. Three people were killed and six injured by gunfire, with an additional five injured after being hit by cars while attempting to flee.",2020
1454,2020-06-22,San Francisco,California,0,5,5,Police discovered five men wounded by gunfire in the Tenderloin neighborhood.,2020
1455,2020-06-22,Minneapolis,Minnesota,0,4,4,Officers responding to a shooting on West Broadway Avenue discovered four people injured.,2020
1456,2020-06-21,Chicago,Illinois,1,3,4,An argument in Humboldt Park escalated shortly after midnight. A man was killed and three wounded.,2020
1457,2020-06-21,Austin,Texas,0,5,5,Five people were wounded in an early morning shooting.,2020
1458,2020-06-21,Minneapolis,Minnesota,1,11,12,"A group of people fired into a crowd, killing one and injuring 11 others.",2020
1459,2020-06-21,Auburn,Alabama,0,4,4,"Shortly after midnight, officers responded to a home after a complaint of gunshots. They discovered four men wounded.",2020
1460,2020-06-21,Milwaukee,Wisconsin,1,4,5,Early in the morning a shooting occurred at a house party. Five individuals were shot and one died on the way to the hospital in a private vehicle.,2020
1461,2020-06-21,Buffalo,New York,0,4,4,Four men were wounded after a shooting at an early morning gathering of cars.,2020
1462,2020-06-20,Wichita,Kansas,0,5,5,Five people were shot at a motel after a party in one of the rooms had an argument that escalated. Police believe the shooting was intended to be targeted.,2020
1463,2020-06-20,Syracuse,New York,0,9,9,Officers arrived at a large party in a public parking lot after reports of a stolen car was made. An individual opened fire as they arrived and injured nine people including a 17-year-old.,2020
1464,2020-06-20,Pinetops,North Carolina,2,2,4,Early in the morning two people were killed and two wounded in a shooting.,2020
1465,2020-06-20,Saginaw,Michigan,1,3,4,A woman sitting in her car was killed and three others injured in a separate car early in the morning. A shoot-out had occurred in a large gathering nearby.,2020
1466,2020-06-20,New York City,New York,0,4,4,Three women and a man were injured after a fight broke out between two groups gathered at Claremont park.,2020
1467,2020-06-20,Detroit,Michigan,0,4,4,Four people were wounded in a drive-by shooting in the evening.,2020
1468,2020-06-20,Jersey City,New Jersey,1,4,5,One person was killed and four injured shortly after midnight.,2020
1469,2020-06-20,Janesville,Wisconsin,0,4,4,Officers responding to a shots fired call in the early morning found four people wounded at an adult entertainment venue.,2020
1470,2020-06-20,New York City,New York,0,4,4,Four people were wounded at an overnight park party in the Bronx after an argument escalated.,2020
1471,2020-06-18,Albany,New York,0,7,7,"Early in the morning a man was discovered by officers with a gunshot wound. Shortly after transporting the man to the hospital, six other victims were identified at local hospitals to be a part of the same shooting.",2020
1472,2020-06-17,Chicago,Illinois,0,4,4,"Three adults and a nine-year-old child were wounded while standing in an apartment complex parking lot in the Gresham neighborhood. A man walked up and opened fire on the group, resulting in a shoot out.",2020
1473,2020-06-16,Fort Dodge,Iowa,2,2,4,"In an apparent shoot out at a birthday party, one man was killed and two women injured. A second man died in his vehicle while attempting to drive away from the scene with a gunshot wound.",2020
1474,2020-06-15,Decatur,Illinois,0,4,4,An early morning shooting during a block party injured four people. The suspected shooter was arrested after a local traffic stop.,2020
1475,2020-06-15,Chicago,Illinois,0,4,4,A 15-year-old and three adults were gathered outside an apartment when they were injured in a drive-by shooting in the Montclare neighborhood.,2020
1476,2020-06-14,New Orleans,Louisiana,1,3,4,One man was killed and three others injured during the evening.,2020
1477,2020-06-14,Lafayette,Louisiana,0,5,5,Officers responded to an early morning shooting and found five people wounded. All but one were transported to local hospitals.,2020
1478,2020-06-14,Lake Charles,Louisiana,0,4,4,Four people were wounded in an early morning shooting at a local night club. A suspected shooter was arrested.,2020
1479,2020-06-14,Louisville,Kentucky,1,4,5,About 100 people were gathered at a skate park in the early morning when someone opened fire. One person was killed and four injured.,2020
1480,2020-06-14,Minneapolis,Minnesota,1,6,7,Early in the morning six people were wounded and one was killed in an incident. Officers were alerted via a ShotSpotter activation.,2020
1481,2020-06-13,Hesperia,California,0,5,5,"Over 100 people attended a house party when someone opened fire, injuring five people.",2020
1482,2020-06-13,Washington D.C.,Washington D.C.,2,5,7,Shortly before midnight responding officers discovered seven shooting victims. A man and woman later died at local hospitals with five other men wounded.,2020
1483,2020-06-13,Atlanta,Georgia,2,5,7,"An individual shot at a large group of people from a vehicle, killing two people and wounding five.",2020
1484,2020-06-13,Rison,Arkansas,0,4,4,"Shortly before midnight, four individuals were wounded in a shooting.",2020
1485,2020-06-13,Wyandanch,New York,1,7,8,One person was killed and seven others wounded after a shooting at a house party. Local police believe the incident is gang related.,2020
1486,2020-06-13,St. Louis,Missouri,1,5,6,Five individuals were wounded and one killed during an early morning shooting in the JeffVanderLou neighborhood.,2020
1487,2020-06-13,Baltimore,Maryl,0,5,5,Five people were wounded in the Fells Point neighborhood during a large gathering at Broadway Square with many of the crowd drinking alcoholic drinks.,2020
1488,2020-06-12,San Antonio,Texas,0,8,8,"A man denied entry into a bar for being too drunk, stated ""Don't you know who I am?"" to the bouncer before leaving. He returned later with a rifle and opened fire injuring five women and three men.",2020
1489,2020-06-12,New York City,New York,1,3,4,A 19-year-old woman was killed and a man and a two teenagers wounded at a local park in the Bronx late at night.,2020
1490,2020-06-12,Philadelphia,Pennsylvania,0,6,6,"Early in the morning five men and one woman were wounded after multiple men opened fire on a group in the Tioga neighborhood, causing the group to scatter and run away.",2020
1491,2020-06-11,Monroe,Louisiana,6,0,6,"A mother killed her neighbor, and four children aged 12, 8, and 5-years-old and a 5-month-old infant, before committing suicide in a murder-suicide.",2020
1492,2020-06-11,Richmond,Virginia,0,4,4,Shortly after midnight responding officers discovered two men wounded by gunfire. Another man and a woman were taken to the hospital in private vehicles.,2020
1493,2020-06-11,Houston,Texas,2,4,6,"Two men were killed, and three men and a 13-year-old were wounded in a drive-by shooting while standing in an apartment complex parking lot.",2020
1494,2020-06-11,Washington D.C.,Washington D.C.,0,7,7,Seven people including two juveniles were wounded in the Trinidad neighborhood of DC. Officers discovered the victims after hearing gunshots in the early morning.,2020
1495,2020-06-10,Sacramento,California,1,3,4,"Shortly before midnight, officers discovered three adults men and one juvenile boy wounded by gunfire. One adult man died later at the hospital.",2020
1496,2020-06-10,Toledo,Ohio,1,3,4,Early in the morning ShotSpotter alerts caused officers to respond to a graduation party. One 18-year-old was killed and with three others wounded.,2020
1497,2020-06-10,Paso Robles,California,2,5,7,"A man shot and killed an individual and wounded an officer, responding officers killed the suspect and three officers were wounded after a short manhunt.",2020
1498,2020-06-09,Vallejo,California,2,3,5,Two women were killed and two adults and a 10-year-old child were injured at a child's birthday party late at night.,2020
1499,2020-06-09,Scotland Neck,North Carolina,0,5,5,Four adults and a six-year-old child were wounded in a drive-by shooting at a home and vehicle.,2020
1500,2020-06-09,Philadelphia,Pennsylvania,1,6,7,"Just before midnight, a shootout occurred in an apartment complex in the Northern Liberties neighborhood. Six people were wounded and a man was found dead behind some cars near the complex.",2020
1501,2020-06-08,New York City,New York,0,4,4,"A woman, two men and a 17-year-old were wounded after an argument escalated in Brooklyn. The shooter fled the scene.",2020
1502,2020-06-08,Memphis,Tennessee,0,4,4,A home was shot at first then after police investigated the shooters return and opened fire. Four people were injured in the second shooting including an 18-month-old infant.,2020
1503,2020-06-07,Chicago,Illinois,0,6,6,Six men were wounded in a late night drive by shooting while standing on the sidewalk.,2020
1504,2020-06-07,Sikeston,Missouri,2,7,9,Two women were killed and seven other individuals wounded at a house party after a drive-by shooting early in the morning.,2020
1505,2020-06-07,Chicago,Illinois,1,3,4,Officers responding to a shots fired call discovered four wounded victims. One victim later died at the hospital and the other three are uncooperative with investigators.,2020
1506,2020-06-07,Dyersburg,Tennessee,0,5,5,Five people were wounded inside the local American Legion club in the early morning. All individuals are refusing to speak with police.,2020
1507,2020-06-07,Hope,Arkansas,0,6,6,Six people between 15 and 21-years-old were wounded in the early morning during an social gathering. A seventh individual broke her leg running from the gunfire.,2020
1508,2020-06-06,Sacramento,California,1,4,5,One person was killed and four people were wounded near a house party after an altercation escalated.,2020
1509,2020-06-06,Ironton,Ohio,0,4,4,Four men were injured after a fight between a large number of people escalated in a local bar's parking lot.,2020
1510,2020-06-06,Kansas City,Missouri,1,4,5,An argument escalated in the early morning with at least two individuals opening fire. One man died and four others were wounded.,2020
1511,2020-06-05,Denver,Colorado,0,4,4,Four people were wounded in an early morning shooting. A juvenile was later arrested in connection with the shooting.,2020
1512,2020-06-04,Valhermoso,Alabama,7,0,7,Shortly before midnight authorities responded to a home fire. Once the fire was extinguished seven adults were discovered dead by gunshot wounds.,2020
1513,2020-06-02,Dallas,Texas,1,3,4,Four people were wounded after two gunman opened fire in a bar. A female victim later died at the hospital.,2020
1514,2020-06-02,Racine,Wisconsin,0,5,5,Three teenagers and two adults aged between 18 and 20-years-old were wounded at a local beach. Officials do not think there is a connection between it and the protests that occurred that night.,2020
1515,2020-06-02,Chicago,Illinois,0,4,4,Four males were wounded while standing on the sidewalk after the shooter approached them and open fire.,2020
1516,2020-06-01,St. Louis,Missouri,0,4,4,Four St. Louis police officers were wounded during an altercation with protestors near police headquarters.,2020
1517,2020-05-31,Philadelphia,Pennsylvania,0,4,4,A 12-year-old and three adults were wounded in a shooting in the Kensington section of the city.,2020
1518,2020-05-31,Gulfport,Mississippi,1,5,6,An 18-year-old was killed and five others injured after someone opened fire early in the morning at a large gathering of people.,2020
1519,2020-05-31,Saginaw,Michigan,0,6,6,Six people were shot when a man opened fire on a block party. The suspect has not been apprehended.,2020
1520,2020-05-30,Gastonia,North Carolina,1,5,6,Six people were shot in the early morning at a block party after multiple individuals opened fire. One of the victims later died at the hospital.,2020
1521,2020-05-30,Houston,Texas,1,4,5,"One person was killed and four wounded including two and 12-year-old children, during a block party.",2020
1522,2020-05-30,Altha,Florida,1,5,6,"One person was killed and five injured including a law enforcement officer, at a birthday party at a local dragstrip.",2020
1523,2020-05-30,Hiawatha,Iowa,1,3,4,"Four people were shot at a mobile home park; three were hospitalized, and one pronounced dead at the scene.",2020
1524,2020-05-29,Portsmouth,Virginia,0,5,5,"Five individuals were wounded in a shooting, including a 10-year-old boy. All victims left the scene for the hospital via private vehicles, while police were called to the scene.",2020
1525,2020-05-28,Memphis,Tennessee,0,4,4,A road rage incident near I-240 wounded two children and two adults.,2020
1526,2020-05-28,Louisville,Kentucky,0,7,7,"Seven people were injured in a shooting during a protest against police brutality in the aftermath of the death of Breonna Taylor, two seriously.",2020
1527,2020-05-28,Philadelphia,Pennsylvania,1,3,4,Two men approached four people sitting on their porch and opened fire in the evening. A man was killed and two others and a woman were injured.,2020
1528,2020-05-27,Philadelphia,Pennsylvania,0,4,4,Four men were shot and wounded in a drive-by shooting in the morning and all taken to the hospital in private vehicles.,2020
1529,2020-05-27,Cleveland,Ohio,1,3,4,"Four people were wounded outside of a gas station, in the early morning. One of the victims later died at the hospital.",2020
1530,2020-05-27,San Jose,California,0,5,5,A group of five men were wounded outside an apartment complex by a shooter before the individual fled on foot.,2020
1531,2020-05-27,Boston,Massachusetts,1,4,5,Five men were found by responding police with gunshot wounds. One later died at the hospital.,2020
1532,2020-05-26,Chicago,Illinois,2,2,4,A man selling items on a street corner was shot and killed in a drive-by shooting. A pedestrian was also killed while two others were wounded.,2020
1533,2020-05-26,Bowman,South Carolina,3,5,8,A drive-by shooting at a neighborhood cookout in the early morning resulted in three individuals dead and five injured.,2020
1534,2020-05-26,Vicksburg,Mississippi,0,4,4,Shortly after midnight four people aged between 16 and 27 were shot in a Waffle House parking lot.,2020
1535,2020-05-26,Philadelphia,Pennsylvania,0,4,4,Four people were wounded in a late night shooting.,2020
1536,2020-05-26,Los Angeles,California,0,5,5,"Five people were wounded in a shooting outside an apartment complex, ranging in age from mid-teens to early 20s.",2020
1537,2020-05-25,Lake Charles,Louisiana,0,6,6,"A 17-year-old shooter and others engaged in a shootout at a graduation party, three 15-year-olds, a 16-year-old, and a 17-year-old were all injured along with the shooter.",2020
1538,2020-05-24,Jackson,Mississippi,1,4,5,"A man was shot and later died at the hospital, while four others, including the suspect, were wounded after a shooting at a private residence.",2020
1539,2020-05-24,St. Louis,Missouri,0,4,4,Four people were shot in the early morning at an intersection.,2020
1540,2020-05-24,Danville,Alabama,3,1,4,Police responding to calls about gunshots found three people dead and one injured at a private residence.,2020
1541,2020-05-24,Myrtle Beach,South Carolina,0,4,4,Four people were wounded shortly after midnight in a potential gang related shooting. Six people have been arrested in connection.,2020
1542,2020-05-23,Jonesville,South Carolina,2,5,7,A man and 17-year-old were killed and five others wounded at a block party after the state's quarantine order was lifted.,2020
1543,2020-05-23,Charlotte,North Carolina,0,6,6,Six people were shot in a parking lot after an argument escalated.,2020
1544,2020-05-23,Daytona,Florida,0,6,6,Two people were shot and four others wounded by bullet fragments after a shooter opened fire on a crowded beach.,2020
1545,2020-05-23,Chicago,Illinois,1,3,4,A shooter pulled up outside a home and opened fire on four men standing on the porch. One was killed and three injured.,2020
1546,2020-05-23,Mount Morris Township,Michigan,1,3,4,A shooting left one dead and three in critical condition. No suspects have been arrested and the investigation is ongoing.,2020
1547,2020-05-23,Fort Lauderdale,Florida,0,5,5,Five men were wounded outside a Jamaican restaurant in the early morning. All were brought to the hospital by private vehicles and have refused to cooperate with police.,2020
1548,2020-05-23,Rock Island,Illinois,1,4,5,A man was killed and four others injured after a large gathering on a street had a fight escalate into a shooting.,2020
1549,2020-05-23,Washington D.C.,Washington D.C.,1,3,4,Officers responding to a shooting found four individuals who were transported to the hospital. One victim died later at the hospital.,2020
1550,2020-05-23,Houston,Texas,0,4,4,"A fight escalated at a bar, with the perpetrator leaving the bar and driving to the back of the bar and opening fire, wounding four men.",2020
1551,2020-05-22,Cleveland,Ohio,1,3,4,A man was killed and three other individuals wounded after shots were fired near a local deli in the early morning.,2020
1552,2020-05-20,Houston,Texas,2,3,5,"A man shot and killed his pregnant ex-girlfriend and wounded her sister, mother, and boyfriend before committing suicide after being surrounding by police.",2020
1553,2020-05-19,Decatur,Illinois,0,5,5,Five men were wounded shortly after midnight.,2020
1554,2020-05-18,Bakersfield,California,0,5,5,"Five teenagers, aged 18 and 17-years-old, were wounded after a man fired into the apartment from outside the complex.",2020
1555,2020-05-17,District Heights,Maryl,1,3,4,Police responded to a suspected shooting and found an 18-year-old dead on the sidewalk. Three injured victims were identified later.,2020
1556,2020-05-17,St. Matthews,South Carolina,4,1,5,A mother and her 15 and 12-year-old daughters were shot and killed by her husband who wounded another daughter before killing himself in a murder-suicide. Another daughter was uninjured and ran for help.,2020
1557,2020-05-17,Charleston,South Carolina,0,4,4,Three people were wounded when an individual opened fire at a party that was hosted at a short term rental. A fourth wounded individual was walking her dog near the home.,2020
1558,2020-05-16,Bogalusa,Louisiana,0,13,13,Hundreds of people had gathered for a memorial service when multiple shooters began firing wounding thirteen people.,2020
1559,2020-05-14,Albuquerque,New Mexico,0,5,5,"Police responding to a call of shots fired discovered five individuals wounded, including a pregnant woman after an argument had escalated.",2020
1560,2020-05-13,Rockford,Illinois,1,4,5,One person was killed and four injured in a believed targeted shooting at a gas station.,2020
1561,2020-05-13,Garrison,Kentucky,1,4,5,Six people were involved in the repossession of a vehicle and one opened fire killing one and injuring four.,2020
1562,2020-05-11,Montgomery,Alabama,0,4,4,Police responding to a call about a gunshot victim discovered one victim with the other three transported to the hospital via private vehicle.,2020
1563,2020-05-10,Fort Worth,Texas,0,5,5,"Five people were wounded in a public park where hundreds were gathered, with some reporting the gunfire was fireworks.",2020
1564,2020-05-10,Katy,Texas,0,6,6,"A dispute between two neighbors escalated causing five people to be wounded, including a five-year-old girl.",2020
1565,2020-05-10,Baton Rouge,Louisiana,0,5,5,"Multiple gunmen were involved in a shootout at a local food market, wounding five including a minor.",2020
1566,2020-05-09,St. Louis,Missouri,0,4,4,Four people were wounded during a late night shooting.,2020
1567,2020-05-07,Baltimore,Maryl,0,4,4,Four men were discovered shot on the city's west side in the evening.,2020
1568,2020-05-06,Albany,Georgia,1,3,4,A 16-year-old was killed and three others wounded in a vehicle after the car was shot multiple times in the early morning.,2020
1569,2020-05-06,Memphis,Tennessee,2,2,4,Two men were shot and killed in a vehicle; two others wounded after attempting to exit the vehicle and were shot at in a drive-by.,2020
1570,2020-05-05,Hammond,Indiana,1,3,4,A man was killed and three others wounded after an incident of road rage escalated.,2020
1571,2020-05-03,Columbus,Ohio,0,4,4,Four people were wounded after an individual opened fire at a house party.,2020
1572,2020-05-03,Jacksonville,Florida,0,4,4,A man drove up to a street and after exiting the car fired at least 30 shots into a crowd of people wounding four men.,2020
1573,2020-05-03,Chicago,Illinois,0,5,5,Five teenagers - aged 15 through 19 years old - were injured in a drive-by shooting after attending a large gathering.,2020
1574,2020-05-02,Philadelphia,Pennsylvania,0,4,4,A man and three women were injured in a shooting in the evening.,2020
1575,2020-04-29,Indianapolis,Indiana,0,4,4,Four people were wounded in a shooting that involved two vehicles and an additional four people near Perry Park.,2020
1576,2020-04-27,Milwaukee,Wisconsin,5,0,5,"Five people were killed in a home, aged between 14 and 41, with a child being uninjured in the violence. Police are treating the incident as a matter of family violence.",2020
1577,2020-04-26,Troy,New York,0,4,4,Four people were wounded in the cities South End in an early morning shooting.,2020
1578,2020-04-26,Salisbury,North Carolina,1,4,5,One individual was killed and four others - including a juvenile - were injured after a fight escalated into a shooting.,2020
1579,2020-04-25,Orlando,Florida,1,4,5,An 18-year-old athlete who was to play at University of Louisville was killed and four others injured in a late night shooting.,2020
1580,2020-04-25,Memphis,Tennessee,0,7,7,Seven people were discovered wounded after police responded to an aggravated assault call. The individuals were wounded in a drive-by shooting after heading to an early morning party.,2020
1581,2020-04-25,Joliet,Illinois,1,3,4,"One person was killed and three others injured, with one being 17-years-old, in an early morning shooting.",2020
1582,2020-04-24,Fort Wayne,Indiana,0,4,4,Police responding to a shots fired call found four people injured.,2020
1583,2020-04-24,Houston,Texas,3,1,4,Three people were killed and one injured in an apartment by two shooters. Due to the lack of forced entry the victims may have known the shooters.,2020
1584,2020-04-18,Hyattsville,Maryl,2,2,4,Two men were killed and two injured in a late night shooting.,2020
1585,2020-04-17,Springfield,Massachusetts,1,4,5,One man was killed and four others injured after multiple individuals opened fire on a backyard gathering before fleeing in a car and continuing to fire.,2020
1586,2020-04-17,Greensboro,North Carolina,1,3,4,Responding police discovered three adults and a juvenile injured by a shooting. An adult later died in the hospital.,2020
1587,2020-04-15,Jackson,Mississippi,1,3,4,A five-year-old girl was killed and three adults wounded after someone shot into an apartment.,2020
1588,2020-04-11,Bakersfield,California,0,6,6,One juvenile and five adults were wounded after at a large party at an apartment complex was fired upon by at least four shooters.,2020
1589,2020-04-10,Muskegon,Michigan,0,4,4,Police were alerted of shots fired shortly after midnight and arrived to find the suspect had fled and the four wounded had transported themselves to the hospital.,2020
1590,2020-04-08,Detroit,Michigan,0,4,4,One man and three women were injured after an altercation escalated. A male shooter escaped the scene and a female was arrested for pointing a weapon at one of the wounded.,2020
1591,2020-04-08,Anchorage,Alaska,0,4,4,Police responding to a call of shots fired found one person wounded and an additional three connected to the shooting were found in local hospitals.,2020
1592,2020-04-08,Greenwood,South Carolina,1,3,4,A 19-year-old was killed and three others individuals were wounded at an apartment complex.,2020
1593,2020-04-07,Chicago,Illinois,1,3,4,"One man was killed and three other individuals wounded, including a 5-year-old, after an individual exited an alley way and opened fire on the group. One of the group likely returned fire at the shooter.",2020
1594,2020-04-05,New York City,New York,0,4,4,Four men were wounded in an early morning shooting in a Brooklyn apartment.,2020
1595,2020-04-05,Lancaster,South Carolina,1,4,5,One man was killed and four other individuals were wounded in a drive-by shooting in which people standing outside a house and sitting in a car were fired upon.,2020
1596,2020-04-05,Los Angeles,California,1,3,4,One man was killed and two other men and one woman were injured in an afternoon shooting.,2020
1597,2020-04-04,Hialeah,Florida,1,4,5,"A man shot and wounded his ex-girlfriend's relatives before barricading himself with her and their 9-year-old child in the home. During the standoff an officer was wounded along with the ex-girlfriend, while the man was killed by police.",2020
1598,2020-04-04,Lubbock,Texas,2,2,4,Police responding to a shots fired call found an adult male and a teenage female deceased and two seriously wounded individuals.,2020
1599,2020-04-04,Vidor,Texas,0,4,4,"Police officers responding to a shots fired call found four wounded individuals, with the shooter arrested later.",2020
1600,2020-04-03,Louisville,Kentucky,0,4,4,Police responding to calls about a shooting discovered two people wounded and a further two wounded drove themselves to the hospital.,2020
1601,2020-03-31,Macon,Georgia,3,1,4,"A domestic argument escalated when a man shot and killed his child's mother, step-father, and sister before abducting his two-year-old child. The shooter was arrested and the child recovered after an Amber Alert was issued.",2020
1602,2020-03-30,Philadelphia,Pennsylvania,0,5,5,"Five people were wounded at a late night memorial gathering after a man fired into the crowd from half-a-block away. The wounded included a two-year-old, a fourteen-year-old, and an eighteen-year-old.",2020
1603,2020-03-29,Atlanta,Georgia,0,4,4,"Four people were wounded in a late night shooting, with two of the wounded under the age of 18. One of the wounded was also showing signs of the COVID-19 virus.",2020
1604,2020-03-28,Baltimore,Maryl,1,3,4,One man was killed and two others and a teenager wounded in a drive-by shooting by three shooters.,2020
1605,2020-03-23,San Antonio,Texas,0,4,4,"Four people in a car were wounded by shooter in the early morning. Three of the victims had transported themselves to hospitals prior to police arrival. The victim found by officers knew who had shot him, but refused to cooperate with police questions.",2020
1606,2020-03-22,Hanahan,South Carolina,0,4,4,Four people were injured in an early morning shooting.,2020
1607,2020-03-20,St. Louis,Missouri,0,4,4,Three men and a woman were shot and wounded leaving a bar early in the morning. A second woman was injured by the crowd fleeing the scene.,2020
1608,2020-03-20,Norfolk,Virginia,0,4,4,Four people were discovered to be wounded in a shooting after police received a report about a shooting.,2020
1609,2020-03-18,Jacksonville,Florida,1,4,5,Five people were shot by a man wearing all black and potentially a face mask and one individual died at the scene. One of the wounded is a three-year-old child.,2020
1610,2020-03-17,Baltimore,Maryl,0,7,7,Police reported that seven people were injured during a police involved shooting. None of those wounded were police officers.,2020
1611,2020-03-15,Springfield,Missouri,5,2,7,"Springfield, Missouri shooting: A shooter killed four people, including a police officer, and injured two others, including another police officer, before committing suicide at a gas station.",2020
1612,2020-03-15,Moncure,North Carolina,7,0,7,Seven adult members of the same family were killed in an apparent murder suicide and were discovered after reports of shots fired.,2020
1613,2020-03-14,Saginaw,Michigan,2,2,4,Police responding to a shooting found three women and one man injured. Two women later were declared deceased.,2020
1614,2020-03-14,Albuquerque,New Mexico,1,3,4,"Reportedly a group of young men burst into a home and started shooting early in the morning. They wounded a woman, a 16-year-old girl and a 17-year-old girl and killed an adult male.",2020
1615,2020-03-13,New Orleans,Louisiana,0,5,5,"Four men riding in a vehicle shot and wounded five people, including a 15-year-old boy, in a drive by shooting, in the Algiers neighborhood.",2020
1616,2020-03-13,Rockford,Illinois,0,4,4,Three men and one woman were wounded after another man opened fire inside of an apartment. The man was later arrested by police.,2020
1617,2020-03-10,Chester,Pennsylvania,2,2,4,Police responding to a shooting discovered two 15-year-old boys killed and a third juvenile injured. A fourth wounded juvenile involved in the shooting was later identified at a medical center.,2020
1618,2020-03-08,Ceres,California,1,3,4,"Police responded to reports of a shooting and discovered three wounded individuals, one of whom later died. A fourth victim arrived at a hospital in a private vehicle.",2020
1619,2020-03-08,Rosedale,Maryl,1,5,6,"A 13-year-old boy was killed, five others were wounded; a 14-year-old boy and girl, two 12-year-old boys and a 19-year-old man were wounded. The group was shot at in a parking lot after an altercation while attending a Triple Threat Elite Dance event.",2020
1620,2020-03-08,South Holland,Illinois,0,4,4,"Four men were wounded in a vehicle on Bishop Ford Freeway, after another vehicle's occupant fired on them.",2020
1621,2020-03-08,Milwaukee,Wisconsin,1,3,4,An early morning argument escalated and resulted in one man killed and three injured outside a local business.,2020
1622,2020-03-07,Cleveland,Ohio,1,17,18,Seventeen people were wounded and one killed after a shootout between multiple motorcycle clubs after a fight at one of the club's headquarters caused many to be thrown out.,2020
1623,2020-03-07,Albuquerque,New Mexico,0,4,4,Three adults and one child were injured by a shooter while exiting a house party. The shooter was later arrested.,2020
1624,2020-03-07,Chicago,Illinois,0,7,7,Six men and a woman were injured in a drive-by shooting after leaving a house party after a fight broke out in the Greater Grand Crossing neighborhood.,2020
1625,2020-03-06,Washington D.C.,Washington D.C.,0,6,6,"Four males, one female and a five-year-old child were discovered by police wounded in a drive-by shooting.",2020
1626,2020-03-04,Tulare,California,1,5,6,One was killed while five others were injured at a mass shooting during a celebration of life. The gunman is still at large.,2020
1627,2020-02-29,Brighton,Colorado,0,5,5,"Five people were wounded in a drive by shooting, before the perpetrators fled.",2020
1628,2020-02-29,Kansas City,Missouri,1,4,5,Four people were injured and one person was fatally wounded at a shooting.,2020
1629,2020-02-26,Milwaukee,Wisconsin,6,0,6,"Milwaukee brewery shooting: Five people were killed when a gunman opened fire at the local Molson Coors Beverage Company campus, where he had been employed. Afterwards, the gunman committed suicide.",2020
1630,2020-02-25,Chicago,Illinois,1,4,5,"A shooting occurred at a convenience store in the Avalon Park neighborhood where four people were hurt and one person was killed. The four wounded victims were listed in serious-to-critical condition. It was reported that three people, including two men and a woman, exited a vehicle and started firing inside the store. They fled in a white vehicle after the arrival of police.",2020
1631,2020-02-25,Lafayette,Louisiana,0,6,6,Six people were injured in a shooting at a business.,2020
1632,2020-02-23,Houston,Texas,0,7,7,Seven people were shot at a flea market where a dance event took place with adults and children. A suspect was arrested and charged with assault. None of the injured victims were critically wounded.,2020
1633,2020-02-23,Clarkton,North Carolina,3,1,4,Three people were killed and one person was injured in a shooting. A suspect turned himself in to local authorities and was charged with three counts of murder and one count of attempted murder.,2020
1634,2020-02-20,Caldwell,Idaho,2,3,5,"Two people were fatally shot and three others, including a police officer, were wounded in a shooting at an apartment complex. The suspect was among the dead.",2020
1635,2020-02-20,Greensboro,North Carolina,0,4,4,Four men were sent to a hospital after police said there were wounded in a shooting in the street. No information about the whereabouts of the shooter were known.,2020
1636,2020-02-20,Orlando,Florida,4,0,4,A man killed his wife and two children before killing himself.,2020
1637,2020-02-19,Philadelphia,Pennsylvania,0,4,4,A shooting occurred in the North Side of the city where four people were injured. Two of the victims were listed in critical condition while the two others were listed in stable condition. A suspect was apprehended and arrested by law enforcement.,2020
1638,2020-02-17,Port Gibson,Mississippi,2,2,4,"Four students of Alcorn State University were involved in a shooting off campus, with two being killed and two others injured.",2020
1639,2020-02-16,Pensacola,Florida,1,4,5,One person was killed and four others were injured in a drive-by shooting. The injured victims were transported to the hospital and two of them were listed in serious condition.,2020
1640,2020-02-16,Midland,Texas,1,3,4,A shooting occurred at a bar where one victim was killed and three others were wounded.,2020
1641,2020-02-16,Hartford,Connecticut,1,4,5,One person was killed and four others were wounded in a shooting at a nightclub. The conditions of the injured are unknown.,2020
1642,2020-02-15,New Orleans,Louisiana,0,4,4,"Four people, two men and two women, were wounded in a shooting blocks away from the city's Mardi Gras Parade route.",2020
1643,2020-02-15,Memphis,Tennessee,0,7,7,Seven people were wounded when an unknown shooter opened fire at a street race after an argument escalated. All were brought to the hospital via private vehicles.,2020
1644,2020-02-14,Chicago,Illinois,0,6,6,Three adults and three children were wounded in a shooting at a gathering in an apartment complex in the South Side of the city.,2020
1645,2020-02-10,Dover,Delaware,1,4,5,One person was fatally shot and four others were wounded in a shooting. It was initially reported that three victims were injured but a fourth one was discovered later and refused medical treatment. The four victims suffered non life-threatening injuries.,2020
1646,2020-02-09,Youngstown,Ohio,3,2,5,"Three people were killed and two others were injured in a shooting at a club. The conditions of the injured are unknown. According to police, one of the victims was found dead inside a car. At least one suspect is in custody.",2020
1647,2020-02-09,San Antonio,Texas,0,4,4,A heated argument turned violent between a man and a woman in front of a house which led to a shooting. Four people were injured as a result of the shooting and were each transported to a hospital. Three of them were listed in serious condition while the fourth was in stable condition. Two of the injured were charged afterwards.,2020
1648,2020-02-08,Houston,Texas,1,3,4,A 29-year-old rap artist was killed and three others were wounded in a shooting in North Houston. The wounded victims' conditions are unknown. The suspects are gang members according to the chief of police.,2020
1649,2020-02-07,Waco,Texas,1,3,4,One man was killed and three others were wounded in a shooting outside and inside a home in Waco. Two of the victims were transported to a hospital by ambulance and were listed in critical condition. The third victim self applied to the hospital but his condition was unknown. Police believe that the motive behind the shooting is the sale of illicit drugs gone wrong.,2020
1650,2020-02-05,Indianapolis,Indiana,4,0,4,Four people were fatally shot on the Northeast section of the city. The victims are three males and one female and their ages are unknown yet. No suspects have been identified or arrested.,2020
1651,2020-02-03,Washington County,Maine,3,1,4,Three people were killed and another was injured in the towns of Machias and Jonesboro. A 63-year-old man has been charged with three counts of murder and one count of attempted murder in the case.,2020
1652,2020-02-03,Grapevine,California,1,5,6,"One person was killed and five others were injured from a shooting on a Greyhound bus heading from Los Angeles to San Francisco. The bus was traversing Tejon Pass on Interstate 5, near Lebec, California, and stopped in Grapevine after the shooting.",2020
1653,2020-02-01,Philadelphia,Mississippi,0,4,4,"Police responded to a street location where multiple shots were fired. They found four victims, aged 18–45 years old, with bullet wounds. Three of the victims were transported by helicopter to a hospital. It is unknown what their conditions are. Police are trying to locate any suspects in the shooting.",2020
1654,2020-02-01,Union Parish,Louisiana,4,0,4,A shooter shot and killed two members of a family and a friend of one of them inside a house. A third fled through a window uninjured and alerted the authorities. The shooter then committed suicide.,2020
1655,2020-01-31,Shreveport,Louisiana,0,4,4,"A shooting occurred at an apartment complex where four teens were injured. All four victims, aged 15–17 years old, suffered non-life-threatening injuries according to first responders.",2020
1656,2020-01-31,Delano,California,1,4,5,One person was killed and four others were injured in a shooting incident that occurred in several locations. One of the injured is in critical condition while the other three are expected to recover. The shooting happened during a memorial gathering for a victim who previously passed away due to a traffic accident.,2020
1657,2020-01-31,Boynton Beach,Florida,1,3,4,A shooting left one victim dead and the other three injured in the 200 block of Northeast First Court.,2020
1658,2020-01-30,Merced,California,0,4,4,Four teenagers were injured in a shooting on public streets. Three of the victims are listed in stable condition while the fourth is in critical condition. Police are interviewing witnesses for their investigation.,2020
1659,2020-01-27,Bridgeport,Connecticut,0,4,4,"Four men were wounded outside the Golden Hill Street Courthouse while sitting in a car, in a drive-by shooting by multiple shooters.",2020
1660,2020-01-26,Hartsville,South Carolina,3,6,9,Three people were fatally shot and four others were injured at a bar.,2020
1661,2020-01-26,Newburgh,New York,3,1,4,"Four family members were shot at a home. Three of the victims are dead and the fourth victim, a child, is wounded and is in serious condition. The suspect was apprehended and arrested by the police.",2020
1662,2020-01-26,Cape Girardeau,Missouri,0,5,5,Multiple shots were fired inside a business where five people were wounded in a shooting.,2020
1663,2020-01-26,Salisbury,North Carolina,0,6,6,"Six people were injured by a shooting shortly after midnight, at a local restaurant. An additional three others were treated for non-gunfire related injuries.",2020
1664,2020-01-24,Lisle,Illinois,2,2,4,A woman killed one person and injured two others before killing herself at a cigar lounge. The victims were Illinois State Troopers.,2020
1665,2020-01-24,Vanceboro,North Carolina,5,0,5,"A man shot and killed his wife and three children, aged between eight months and four years old, along with the family dog. He then killed himself.",2020
1666,2020-01-22,Seattle,Washington,1,7,8,"Eight people were shot, one fatally, outside a McDonald's on Pine Street in Downtown Seattle.",2020
1667,2020-01-19,San Antonio,Texas,2,5,7,Two people were killed and five others injured at a nightclub.,2020
1668,2020-01-19,Kansas City,Missouri,2,15,17,Two people  were killed and fifteen others were injured during a shooting at a nightclub.,2020
1669,2020-01-19,South Houston,Texas,2,2,4,Police discovered two people dead and two injured after responding to a shooting.,2020
1670,2020-01-19,Memphis,Tennessee,1,4,5,One person was killed and four others were injured during a shooting outside a nightclub.,2020
1671,2020-01-17,Grantsville,Utah,4,1,5,"Haynie family shooting: Four people were killed and one was injured after a teenager allegedly fired at his family at their house. He was charged with four counts of aggravated murder, one count of attempted aggravated murder and five counts of illegal discharge of a firearm.",2020
1672,2020-01-16,Chicago,Illinois,0,5,5,Three children between 11 and 16 years old were injured along with two adults after two perpetrators fired into a barber shop in the East Garfield Park neighborhood.,2020
1673,2020-01-15,Des Moines,Iowa,2,2,4,Two people were killed and two injured after a shooting in a home's detached garage.,2020
1674,2020-01-11,Aurora,Colorado,0,5,5,"Five people, including three teenagers, were wounded by a 16-year-old shooter at an apartment building.",2020
1675,2020-01-08,Bay Saint Louis,Mississippi,2,2,4,Two people were killed and two injured in a random ambush style shooting. The perpetrator was arrested after arriving at his mother's house covered in blood.,2020
1676,2020-01-05,Atlanta,Georgia,0,4,4,Four people were injured by a single person after an argument near a northwestern Atlanta nightclub early in the morning.,2020
1677,2020-01-04,Ocala,Florida,1,3,4,One man was killed and three men were injured in a mid morning shooting.,2020
1678,2020-01-02,New York City,New York,0,4,4,Four people were wounded in a drive-by shooting outside an apartment building in the Sunset Park neighborhood.,2020
1679,2020-01-01,Trujillo Alto,Puerto Rico,4,1,5,"A family of four, including nine-year-old twin boys, were shot and killed at their home after celebrating New Year's Eve. A 16-year-old boy was seriously injured.",2020
1680,2020-01-01,Huntington,West Virginia,0,7,7,"Seven people were wounded inside and out a hookah bar early in the morning, after an argument escalated.",2020
1681,2020-01-01,St. Louis,Missouri,3,1,4,Responding police discovered three people dead and one wounded at an early morning shooting in the Benton Park neighborhood.,2020
1682,2020-01-01,Cleveland,Ohio,0,4,4,An argument in a Downtown Cleveland night club's VIP section led to three people being wounded and a fourth person was shot in the head in the back alley.,2020
1683,2019-12-29,Danville,Illinois,0,5,5,Five women aged 18 to 32 years old were injured by gunfire after the home they were in was shot at by an unknown person.,2019
1684,2019-12-29,Buffalo,New York,1,3,4,"After an argument escalated on a front porch, four people were wounded by gunfire, with one man dying later at the hospital.",2019
1685,2019-12-29,White Settlement,Texas,3,0,3,"West Freeway Church of Christ shooting: Two people were killed inside the West Freeway Church of Christ by a gunman before he was shot and killed by a member of the security team. The attack was livestreamed, leading to numerous social media posts showing the shooting in progress.",2019
1686,2019-12-29,Ceres,California,0,5,5,Five people were shot outside a home after returning from a bar in Modesto where they had been involved in an altercation.,2019
1687,2019-12-27,Houston,Texas,2,7,9,Two people were killed and seven injured in a drive-by shooting at a music video set.,2019
1688,2019-12-27,Kennesaw,Georgia,0,4,4,Officers responding to a call about an individual shot arrived at a house party and found four teenagers injured.,2019
1689,2019-12-27,Modesto,California,1,3,4,Officers responding to a call of suspicious circumstances near an intersection found one man killed and two others and a woman injured.,2019
1690,2019-12-26,St. Petersburg,Florida,0,5,5,"Five people were wounded by gunfire outside a night club, with an additional three injured by the resulting building damage and chaos. The shooting occurred after an altercation escalated out onto the street.",2019
1691,2019-12-25,Oakland,California,0,4,4,Four people wounded by gunfire were discovered by police after responding to a house party.,2019
1692,2019-12-25,Coralville,Iowa,1,3,4,"Police responding to reports of shots fired discovered four wounded victims, one of which died later at the hospital.",2019
1693,2019-12-25,Richmond,Virginia,1,3,4,"One person was killed and three injured in a shooting outside a bar, after an earlier argument in a restaurant.",2019
1694,2019-12-24,High Point,North Carolina,0,6,6,Six people were wounded in a shooting in which the perpetrator was believed to have exited a vehicle and opened fire before leaving in it.,2019
1695,2019-12-24,New Orleans,Louisiana,0,4,4,Shooters wearing ski masks exited a vehicle and wounded four people before fleeing.,2019
1696,2019-12-22,Chicago,Illinois,0,13,13,"Thirteen people were shot at a party that was held to memorialize a victim of an earlier shooting, at least one was a teenager.",2019
1697,2019-12-22,Baltimore,Maryl,0,7,7,"Seven people were wounded in an early morning shooting, including two 17-year-olds.",2019
1698,2019-12-21,Waynesbroro,Mississippi,1,6,7,One person was killed and six injured in an apartment complex after a drive-by shooting.,2019
1699,2019-12-20,Tuskegee,Alabama,2,2,4,Two people were killed and two were injured in a late night double homicide.,2019
1700,2019-12-20,Winston-Salem,North Carolina,2,2,4,Two people were killed and a police officer and bystander injured at the local Sanitation Department after a fight escalated.,2019
1701,2019-12-19,Westerly,Rhode Isl,2,2,4,"A resident at Babcock Village Apartments shot two employees, one fatally, and one resident before killing himself.",2019
1702,2019-12-18,San Antonio,Texas,0,4,4,Four people were shot at the South Park Mall.,2019
1703,2019-12-17,Great Falls,Montana,4,1,5,Three people are killed and one wounded in a shooting at the Emerald City Casino. The suspect was later killed by police at a different location.,2019
1704,2019-12-15,Columbus,Georgia,1,4,5,One man was killed and four others injured at an intersection early in the morning.,2019
1705,2019-12-14,Ivanhoe,California,0,4,4,Four teenagers were wounded in a drive-by shooting at an apartment complex.,2019
1706,2019-12-12,St. Louis,Missouri,1,3,4,One man was killed and three wounded in a business parking lot.,2019
1707,2019-12-10,Jersey City,New Jersey,6,3,9,"2019 Jersey City shooting: Four people were killed, including a police officer, and another three were injured in an ambush style shootout by a man and woman who were killed by police. The suspects were Black Hebrew Israelites members and targeted a kosher grocery store.",2019
1708,2019-12-10,Edinburg,Texas,4,0,4,"Four people were discovered dead in a home, in either by a murder-suicide or a quadruple homicide. A toddler was also in the home, unharmed.",2019
1709,2019-12-08,Desoto,Texas,2,3,5,"Two men were killed and three injured at an apartment building. The incident was originally reported as a home invasion, although the account was not confirmed.",2019
1710,2019-12-08,New Orleans,Louisiana,1,4,5,"Five people were shot outside a local bar, with one man dying of his injuries at the hospital.",2019
1711,2019-12-06,Pensacola,Florida,4,8,12,Naval Air Station Pensacola shooting: A man killed three individuals and injured eight more at Naval Air Station Pensacola before being killed by police. A terrorist motive is suspected to be behind the attack.,2019
1712,2019-12-05,Miramar,Florida,4,1,5,"2019 Miramar shootout: Four people are dead and one injured after a pair of men rob a jewelry store in Coral Gables, injuring the clerk, then carjack a UPS truck and lead police on a chase that ended in a shootout in Miramar that killed the UPS driver, a bystander, and the suspects.",2019
1713,2019-12-04,Pearl Harbor,Hawaii,3,1,4,"22-year-old Gabriel Romero, a US Navy sailor and submarine crewman, randomly opened fire just minutes after starting his shift for routine guard duty at at Joint Base Pearl Harbor–Hickam. He opened fire on a group of civilian workers, killing two and wounded another, before immediately shooting himself. The motive is thought to be a toxic cultural environment in the USN, particularly among submarine crewman.",2019
1714,2019-12-04,Montgomery,Alabama,2,2,4,Two people were killed and two wounded in an apartment complex.,2019
1715,2019-12-01,Comstock Township,Michigan,1,3,4,One person was killed and three police officers wounded when a home invasion turned into a hostage situation.,2019
1716,2019-12-01,Cotton Valley,Louisiana,2,3,5,"One woman was killed and three others wounded, including a perpetrator, after an argument escalated at a nightclub.",2019
1717,2019-12-01,New Orleans,Louisiana,2,2,4,Two people were killed and two injured at an intersection hours after the first mass shooting in the city.,2019
1718,2019-12-01,New Orleans,Louisiana,0,10,10,2019 New Orleans shooting: Ten people were shot in a densely populated area with heavy police presence at a time when tens of thousands of tourists were downtown for the Bayou Classic football game.,2019
1719,2019-12-01,Aurora,Illinois,1,4,5,"One person was killed and four were injured in a shooting in Aurora, Illinois.",2019
1720,2019-11-29,Amarillo,Texas,0,7,7,Seven people were shot at a nightclub in the early morning.,2019
1721,2019-11-27,New York City,New York,0,5,5,Five people were wounded including two children aged 10 and 15.,2019
1722,2019-11-25,Brownsville,Florida,2,2,4,Two men were killed and two others wounded in a drive-by shooting. One suspect was arrested after the car crashed into a parked police car.,2019
1723,2019-11-24,Birmingham,Alabama,1,4,5,One person was killed and four others injured in a drive-by shooting after being made to leave a club following an argument.,2019
1724,2019-11-24,Los Angeles,California,0,6,6,Six people were wounded at a warehouse party after an argument escalated and the perpetrator opened fire.,2019
1725,2019-11-24,Cottonport,Louisiana,2,2,4,Two people were killed and two others injured in an early morning shooting at a club.,2019
1726,2019-11-23,Los Angeles,California,0,4,4,Four people were wounded at an outdoor party after a fight broke out.,2019
1727,2019-11-23,Tallulah,Louisiana,1,6,7,One person was killed and six injured after an argument at a club escalated and the perpetrator began to fire randomly.,2019
1728,2019-11-21,Everett,Washington,0,4,4,Four people were wounded in an apartment complex during a large gathering.,2019
1729,2019-11-21,Long Beach,California,0,5,5,Five people were wounded randomly as a man drove down a road and opened fire on pedestrians.,2019
1730,2019-11-20,Richmond,California,0,4,4,Four people were wounded in a shooting.,2019
1731,2019-11-18,Newark,New Jersey,1,3,4,One person was killed and three people were injured in two homes on one street.,2019
1732,2019-11-17,Fresno,California,4,6,10,"2019 Fresno shooting: Ten people were shot, four fatally, at a football watch party.",2019
1733,2019-11-17,Cleveland,Ohio,0,4,4,Four people were wounded outside a home by a drive-by shooting.,2019
1734,2019-11-16,San Diego,California,5,1,6,"A man killed his estranged wife and their three children, wounding a fourth child, before killing himself.",2019
1735,2019-11-14,Santa Clarita,California,3,3,6,"Saugus High School shooting: A high school student shot five classmates, two fatally, before shooting himself; he died the next day in the hospital.",2019
1736,2019-11-11,Belle Glade,Florida,0,4,4,Four people were shot randomly along a road.,2019
1737,2019-11-10,Kansas City,Missouri,0,4,4,Four people were wounded outside a night club after a disturbance escalated.,2019
1738,2019-11-10,Memphis,Tennessee,1,4,5,A woman was killed and four others were wounded during an early morning shooting at a strip club.,2019
1739,2019-11-10,Little Rock,Arkansas,0,4,4,"An adult male and three children, aged 12 through 13-years-old, were wounded by an unknown perpetrator while filming a rap music video.",2019
1740,2019-11-09,Detroit,Michigan,0,4,4,Four men were wounded in a drive-by shooting in a parking lot.,2019
1741,2019-11-09,Vidalia,Georgia,0,4,4,"Two vehicles were shot at, wounding three adults and a 10-year-old child.",2019
1742,2019-11-07,Conyers,Georgia,2,3,5,An argument escalated and left one man injured and another dead. The shooter then engaged in a shootout with officers injuring two officers before being killed.,2019
1743,2019-11-04,Houston,Texas,1,3,4,A man was killed and three other people were injured when a person opened fire at a group in a driveway.,2019
1744,2019-11-03,Toledo,Ohio,0,4,4,Officers responding to a Shotspotter alert found four people wounded at a nightclub.,2019
1745,2019-11-03,Nacogdoches,Texas,1,3,4,"A man shot at five men working on a barn, killing one and injured three others.",2019
1746,2019-11-02,Detroit,Michigan,1,4,5,One person was killed and five injured at an after hours party.,2019
1747,2019-11-02,Baton Rouge,Louisiana,0,4,4,Four people were wounded in a shooting.,2019
1748,2019-11-01,Tolleson,Arizona,0,5,5,Five teenagers were wounded at a Halloween party in a vacant home.,2019
1749,2019-11-01,San Angelo,Texas,0,4,4,Four people were wounded in a drive-by shooting outside a night club.,2019
1750,2019-10-31,Orinda,California,5,4,9,"Orinda shooting: At an overnight Halloween party attended by over 100 people, five people were killed, and four more wounded by gunfire.",2019
1751,2019-10-29,Long Beach,California,3,9,12,Three men were killed and nine injured at a Halloween party at a residential home.,2019
1752,2019-10-28,Baltimore,Maryl,1,3,4,A man was killed and two adults and a 17-year-old were injured in front of a store.,2019
1753,2019-10-27,Lansing,Michigan,1,4,5,One man was killed and four others were injured at a house party.,2019
1754,2019-10-27,Detroit,Michigan,0,4,4,Four men were injured in a random drive by shooting.,2019
1755,2019-10-27,Greenville,Texas,2,10,12,Two men were killed and ten others injured at a large party to celebrate Texas A&M University's homecoming weekend.,2019
1756,2019-10-26,Jersey City,New Jersey,0,4,4,Four people were wounded in a late night shooting.,2019
1757,2019-10-24,Oklahoma City,Oklahoma,2,2,4,Two people were killed and two injured at a home late at night.,2019
1758,2019-10-22,Oklahoma City,Oklahoma,1,3,4,One person was killed and three wounded at an apartment complex late at night.,2019
1759,2019-10-21,Sumter,South Carolina,0,4,4,Four people were shot at random and wounded by a lone gunman.,2019
1760,2019-10-20,Port Arthur,Texas,1,3,4,A woman was killed and three others injured in an early morning shooting.,2019
1761,2019-10-19,El Paso,Texas,1,3,4,One man was killed and two others and a woman were injured in an early morning shooting.,2019
1762,2019-10-19,Duquesne,Pennsylvania,0,4,4,Four people were shot in a drive-by shooting.,2019
1763,2019-10-15,Miami,Oklahoma,2,2,4,A man killed his 11-year-old daughter and wounded her mother and the mother's boyfriend before committing suicide.,2019
1764,2019-10-15,Columbus,Ohio,0,4,4,Three teenagers and an adult male were injured while sitting on a porch.,2019
1765,2019-10-14,San Juan,Puerto Rico,6,0,6,2019 Río Piedras shooting: Six people were killed in a shootout at a housing project.,2019
1766,2019-10-14,Philadelphia,Pennsylvania,3,1,4,A woman killed her two children and her husband before attempting to commit suicide.,2019
1767,2019-10-13,Akron,Ohio,0,4,4,One woman and three men were wounded outside a bar.,2019
1768,2019-10-13,Philadelphia,Pennsylvania,0,6,6,A 14-year-old boy and five men were wounded while standing on the street.,2019
1769,2019-10-12,Baltimore,Maryl,1,3,4,A man was killed and three others injured.,2019
1770,2019-10-12,New York City,New York,4,3,7,Four people were killed and three injured at a social club.,2019
1771,2019-10-12,Crosby,Texas,0,4,4,Four men were wounded after a brawl near a gas station.,2019
1772,2019-10-12,Eastpointe,Michigan,1,5,6,One person was killed and five injured after an argument escalated in a local bar.,2019
1773,2019-10-12,Chicago,Illinois,5,0,5,Four people were killed and one injured after a neighbor entered their apartment and opened fire. The fifth victim died of her injuries later in hospital.,2019
1774,2019-10-10,Philadelphia,Pennsylvania,0,5,5,Five men were wounded after a driver was angered over a game of dice.,2019
1775,2019-10-10,Milwaukee,Wisconsin,1,3,4,"A man was killed while another man and two children, ages 10 and 14, were wounded.",2019
1776,2019-10-10,Tampa,Florida,2,2,4,Two people were killed and two wounded at a mobile home.,2019
1777,2019-10-09,Baltimore,Maryl,1,3,4,"A man was killed and three other individuals, including a 15-year-old boy, were injured.",2019
1778,2019-10-07,Abington,Massachusetts,5,0,5,"A family of five, two adults and three children, were found shot to death in their home in an apparent murder-suicide.",2019
1779,2019-10-06,Denver,Colorado,0,4,4,"An argument escalated during a large gathering outside a home, and four people were wounded.",2019
1780,2019-10-06,Evansville,Indiana,0,5,5,"An argument inside of an American Legion bar escalated, and five men were shot as they left the bar.",2019
1781,2019-10-06,Kansas City,Kansas,4,5,9,Four people were killed and another five people wounded in a shooting at a bar.,2019
1782,2019-10-05,Lawton,Oklahoma,4,0,4,Two adults and two children were discovered dead in a home.,2019
1783,2019-10-03,Roxboro,North Carolina,1,3,4,A man was killed and three others wounded.,2019
1784,2019-10-03,Marshall,Missouri,1,3,4,Three people were wounded and a fourth later died at the hospital in a shooting.,2019
1785,2019-10-01,St. Louis,Missouri,0,4,4,Four men were wounded after two cars drove by a crowd of people and opened fire.,2019
1786,2019-09-29,Clafin,Kansas,0,4,4,Four people were wounded after an individual fired a shotgun towards a group of people at a house party.,2019
1787,2019-09-29,Jacksonville,Florida,0,4,4,Four people were injured while attending a large party after an individual fired into the air.,2019
1788,2019-09-29,Milwaukee,Wisconsin,0,4,4,Four young women were injured after an individual fired into a home were a house party was being held.,2019
1789,2019-09-29,Round Lake,Illinois,1,3,4,A man was killed and three injured after unknown individuals attempted to crash a house party and began shooting.,2019
1790,2019-09-29,Beaumont,Texas,4,0,4,Four men were shot and killed at an apartment complex after a disturbance between roommates escalated.,2019
1791,2019-09-27,Seaman,Ohio,3,1,4,A man killed his mother then drove to a gas station where he attempted to kidnap a clerk then killed a man and injured the clerk before robbing another gas station and committing suicide.,2019
1792,2019-09-24,Chicago,Illinois,1,3,4,A 17-year-old boy was killed and three adults were injured in the Lower West Side.,2019
1793,2019-09-23,Gary,Indiana,2,2,4,Two men were killed and a woman and man injured in an early morning shooting.,2019
1794,2019-09-22,Independence,Missouri,0,5,5,Five people were wounded at The SPOTT Lifestyle and Swingers Club.,2019
1795,2019-09-21,Lancaster,South Carolina,2,8,10,"Ten people were shot, two fatally, during a bar fight that escalated.",2019
1796,2019-09-21,Indianapolis,Indiana,0,6,6,Three adults and three juveniles were injured after a fight escalated.,2019
1797,2019-09-21,New Orleans,Louisiana,0,4,4,Four people were wounded after shot were fired into their car.,2019
1798,2019-09-21,South Bend,Indiana,1,3,4,A man was killed and three women injured in an early morning shooting.,2019
1799,2019-09-20,New Orleans,Louisiana,1,5,6,"Six people were shot, one fatally, at an intersection in the Mid-City Area.",2019
1800,2019-09-19,Washington D.C.,Washington D.C.,1,5,6,"A man was killed, and four others and a woman injured, in a possible drive-by in the Columbia Heights District.",2019
1801,2019-09-18,Chicago,Illinois,3,1,4,Three men were killed and one injured after an argument about cigarettes escalated outside a West Garfield Park convenience store.,2019
1802,2019-09-18,Los Angeles,California,2,2,4,"A man and woman were killed, and two other women injured, in the Wilmington neighborhood after an individual shot into a crowd of people.",2019
1803,2019-09-16,Cheyenne,Wyoming,2,2,4,"Two adults killed, two juveniles injured in east Cheyenne shooting.",2019
1804,2019-09-14,LaGrange,Georgia,0,4,4,Four individuals were wounded after an individual opened fire.,2019
1805,2019-09-14,St. Louis,Missouri,2,2,4,"Responding police officers discovered a car covered in gunshots, and discovered a deceased male and two men and a female injured. One of the injured men later died.",2019
1806,2019-09-14,Oakland,California,1,4,5,"An argument escalated between two men outside a Laurel District bar, leading to a man killed and three men and a woman injured.",2019
1807,2019-09-13,Cincinnati,Ohio,0,4,4,A feud between two men led to four people being injured after it escalated in the North Fairmont neighborhood.,2019
1808,2019-09-12,Albuquerque,New Mexico,1,3,4,One person was killed and three others injured at a local apartment complex.,2019
1809,2019-09-12,Albuquerque,New Mexico,4,2,6,"Two adults, a 16-year-old girl, and a 17-year-old boy were killed and two others injured in a mobile home park.",2019
1810,2019-09-10,Chicago,Illinois,0,4,4,Three young adult males and a 17-year-old boy were injured in the back of a house in the West Town neighborhood.,2019
1811,2019-09-08,Alexandria,Louisiana,1,3,4,A woman shot and killed one woman and injured three others after a continuation of an argument escalated.,2019
1812,2019-09-08,Sumter,South Carolina,2,3,5,"Two men were killed and three other individuals injured at a local convenience store, in the early morning.",2019
1813,2019-09-07,Whiteville,North Carolina,3,1,4,"A husband, wife and their five-year-old son were killed while the grandmother was injured in a targeted attack.",2019
1814,2019-09-06,Saint Croix,United States Virgin Isls,0,4,4,Four people were shot at a housing community.,2019
1815,2019-09-04,Jacksonville,Florida,0,4,4,Three adults and a child were wounded in a shooting.,2019
1816,2019-09-04,Marrero,Louisiana,2,2,4,"A man and a seven-year-old girl were killed, and another man and a 11-year-old boy were injured after an argument apparently escalated.",2019
1817,2019-09-02,Elkmont,Alabama,5,0,5,A 14-year-old boy shot dead five family members – two adults and three children – in an Alabama residence. He confessed the crime to the police.,2019
1818,2019-09-02,Chicago,Illinois,0,4,4,Four men were wounded in a drive-by shooting outside of a CTA Green Line station in Washington Park.,2019
1819,2019-09-02,Greensboro,North Carolina,2,2,4,Two men were killed and a woman and small child injured during a home invasion.,2019
1820,2019-09-01,Rocky Mount,North Carolina,0,4,4,Four people were shot at a private party at a Moose Lodge.,2019
1821,2019-09-01,Valley,Alabama,0,7,7,Six adult males and a 15-year-old boy were wounded outside a kindergarten after an argument over a Lanett vs. Lafayette football game escalated.,2019
1822,2019-09-01,Hartford,Connecticut,0,4,4,Three men and a 17-year-old boy were wounded in a shooting.,2019
1823,2019-09-01,Toledo,Ohio,0,4,4,Four people were found shot in the early morning.,2019
1824,2019-08-31,Odessa and Midland,Texas,8,25,33,"Midland–Odessa shooting: Eight people were killed, including the perpetrator, and 25 were wounded when a gunman opened fire on police and civilians after fleeing from a traffic stop.",2019
1825,2019-08-31,Charlotte,North Carolina,1,3,4,A man was killed and three others were injured at a University of North Carolina at Charlotte off-campus apartment complex.,2019
1826,2019-08-31,Frederick,Maryl,0,4,4,Four people were injured after an argument escalated.,2019
1827,2019-08-30,Baltimore,Maryl,1,3,4,A woman was killed and three others were injured in a possible retaliation to a previous stabbing.,2019
1828,2019-08-30,Mobile,Alabama,0,10,10,"Ten people, ranging in age from 15 to 18, were injured at a high school football game after a fight escalated.",2019
1829,2019-08-29,Baltimore,Maryl,1,3,4,"A 16-year-old boy was killed, while two teen boys – a 14-year-old and 15-year-old – and an adult woman were injured.",2019
1830,2019-08-26,Pembroke Falls,Florida,4,0,4,"A man killed his wife, mother-in-law, and one of his three-year-old twin daughters before committing suicide.",2019
1831,2019-08-25,Chicago,Illinois,1,3,4,A 17-year-old boy was killed and three adults were wounded after a large group was fired upon.,2019
1832,2019-08-25,Hobbs*,New Mexico,3,4,7,"2019 Hobbs, New Mexico party shootingPolice responded to a party due to a shots fired call and found three dead and four wounded.",2019
1833,2019-08-24,Temple,Maryl,0,7,7,Seven people were wounded at a two-year-old's birthday party after a fight escalated.,2019
1834,2019-08-24,Lynn,Massachusetts,1,3,4,A man was killed and three were injured while attending a basketball tournament.,2019
1835,2019-08-24,Coconut Creek,Florida,2,3,5,"Two people were killed and three were injured, including a police officer, in a shooting. A suspect was apprehended.",2019
1836,2019-08-23,St. Louis,Missouri,1,3,4,An eight-year-old girl was killed and three others were wounded in a shooting near Soldan High School.,2019
1837,2019-08-23,Houston,Texas,2,2,4,Two men were killed and a man and woman were injured in a drive-by shooting.,2019
1838,2019-08-22,Columbia,South Carolina,2,2,4,"A man opened fire on patrons at a bar, killing two and wounding two others, after being kicked out.",2019
1839,2019-08-22,Los Angeles,California,0,4,4,"Four people, including a social worker and a security guard were wounded in the Skid Row district.",2019
1840,2019-08-20,Atlanta,Georgia,0,4,4,Four female students from Clark Atlanta University and Spelman College were wounded during a block party.,2019
1841,2019-08-18,Kansas City,Missouri,0,4,4,Four teenagers were wounded after an argument escalated during a gathering in a hotel room.,2019
1842,2019-08-17,Newport News,Virginia,1,3,4,"A woman was killed, and responding officers engaged with the suspect causing an officer, bystander and the suspect to be wounded.",2019
1843,2019-08-17,Houston,Texas,0,7,7,Seven people were injured in a shooting at a party.,2019
1844,2019-08-17,Kansas City,Missouri,0,4,4,Police responded to a shooting call and discovered four people wounded.,2019
1845,2019-08-15,Montgomery,Alabama,2,3,5,Two people were killed and three wounded in a shooting near Alabama State University.,2019
1846,2019-08-15,Philadelphia,Pennsylvania,0,5,5,Four men and a teenage boy were wounded.,2019
1847,2019-08-14,Philadelphia,Pennsylvania,0,6,6,Six Philadelphia Police officers were shot during an eight-hour standoff while attempting to serve a drug warrant.,2019
1848,2019-08-14,New Manchester,West Virginia,1,5,6,A man killed his girlfriend and injured five others and a dog before being wounded by police and arrested.,2019
1849,2019-08-13,Tacoma,Washington,2,3,5,Police responded to calls of shots fired and found a deceased male and three women wounded. One died at the hospital from their injuries.,2019
1850,2019-08-13,Greenwood,Mississippi,0,4,4,Four people were wounded in a shooting.,2019
1851,2019-08-12,Riverside,California,2,2,4,A police officer was killed and two were wounded after a suspect opened fire during a traffic stop. The suspect was killed by police.,2019
1852,2019-08-12,Hickory,North Carolina,3,1,4,"A man shot and killed his estranged wife and a man, then wounded another man before committing suicide.",2019
1853,2019-08-11,Chicago,Illinois,0,6,6,Six people were injured when they were shot by a gunman in a car in Garfield Park.,2019
1854,2019-08-10,San Francisco,California,0,4,4,Four people were injured in an overnight shooting in the parking lot of a McDonald's restaurant.,2019
1855,2019-08-10,Richmond,Virginia,0,4,4,Four people were injured in a shooting.,2019
1856,2019-08-09,Chicago,Illinois,0,4,4,Four people were injured in a drive-by shooting in Marquette Park.,2019
1857,2019-08-09,Houston,Texas,0,4,4,Four men were injured during a shoot-out at a convenience store.,2019
1858,2019-08-08,Irvington,New Jersey,1,3,4,A gunman wearing body armor killed another man and wounded three responding police officers before being arrested.,2019
1859,2019-08-07,St. Louis,Missouri,2,2,4,Two people were killed and two were injured in a shooting that also involved a motor vehicle crash.,2019
1860,2019-08-06,Detroit,Michigan,0,4,4,Four people were shot and injured after a dispute.,2019
1861,2019-08-06,Stone Mountain,Georgia,4,0,4,"A man killed two women and a man, before killing himself in a triple murder–suicide.",2019
1862,2019-08-05,Suitland,Maryl,1,3,4,One person was killed and three were wounded after a large fight broke out following a funeral service.,2019
1863,2019-08-05,New York City,New York,0,4,4,Four people were injured in a shooting during a candlelight vigil in Crown Heights.,2019
1864,2019-08-05,San Antonio,Texas,4,0,4,"A man killed his uncle, grandmother and mother before he set the house on fire and committed suicide in a triple murder–suicide.",2019
1865,2019-08-04,Memphis,Tennessee,1,3,4,One man was killed and three others were injured in an early morning shooting.,2019
1866,2019-08-04,Grenada,Mississippi,0,4,4,Four people were discovered wounded in an overnight shooting.,2019
1867,2019-08-04,Chicago,Illinois,1,7,8,One person was killed and seven others were injured in a shooting in the Lawndale community.,2019
1868,2019-08-04,Chicago,Illinois,0,7,7,Seven people were wounded in a drive-by shooting near Douglass Park.,2019
1869,2019-08-04,Dayton,Ohio,10,27,37,"2019 Dayton shooting: A gunman killed nine people and injured 27 outside of a bar after he was denied entry, before being killed by police.",2019
1870,2019-08-03,El Paso,Texas,23,23,46,2019 El Paso shooting: 23 people were killed and 23 were injured at a Walmart near the Cielo Vista Mall in a Hispanophobic massacre. The perpetrator was taken into custody.,2019
1871,2019-08-02,Suffolk,Virginia,2,3,5,"Two men were killed, and two women and a two-year-old were wounded at multiple crime scenes.",2019
1872,2019-08-02,Pomfret,Maryl,3,1,4,"A man shot and killed his in-laws, and wounded an 11-year-old boy sitting in a relative's car before committing suicide.",2019
1873,2019-07-31,Elkhart,Indiana,3,1,4,"Police responding to shots fired at a senior living complex discovered a wounded woman, and two males and a woman deceased. It is believed one of the deceased males was the shooter.",2019
1874,2019-07-30,Southaven,Mississippi,2,2,4,"At a Walmart store, a man killed two people then wounded a police officer before being shot by police and arrested.",2019
1875,2019-07-30,Haskell,Oklahoma,0,4,4,"During an attempted home invasion, shots were fired and four people were wounded.",2019
1876,2019-07-30,Rosenberg,Texas,3,1,4,"A man shot and killed his ex-girlfriends parents, and wounded her, before committing suicide in a murder–suicide.",2019
1877,2019-07-30,Columbus,Ohio,0,5,5,Five people were shot at a party at a home rented through Airbnb.,2019
1878,2019-07-28,Philadelphia,Pennsylvania,1,5,6,One man was killed and five were injured by an unknown perpetrator as the victims were preparing to shoot a rap video.,2019
1879,2019-07-28,Chippewa Falls,Wisconsin,5,2,7,"A gunman shot six people, four fatally, before killing himself.",2019
1880,2019-07-28,Chicago,Illinois,0,4,4,One woman and three men were wounded in a drive-by shooting outside of a Lawndale gas station.,2019
1881,2019-07-28,Gilroy,California,4,17,21,"Gilroy Garlic Festival shooting: Sixteen people were shot, four fatally, including a gunman and two children, at the Gilroy Garlic Festival.",2019
1882,2019-07-28,Uniontown,Pennsylvania,0,4,4,Four people were wounded on two separate streets in connection with a large party.,2019
1883,2019-07-28,Washington D.C.,Washington D.C.,0,4,4,Four people were shot and injured while standing outside of a bar/nightclub.,2019
1884,2019-07-27,New York City,New York,1,12,13,"Thirteen people were shot, one fatally, at a playground in Brownsville.",2019
1885,2019-07-27,Wichita,Kansas,1,3,4,One man was killed and three were injured after an altercation at an apartment complex. The suspect was later arrested.,2019
1886,2019-07-25,Albemarle,North Carolina,3,1,4,"Officers responded to a call at a residence and discovered three deceased victims, and one wounded male, resulting from a double murder–suicide.",2019
1887,2019-07-25,Los Angeles,California,4,2,6,"A man killed four people, including his father and brother, and wounded two more at a total of four different crime scenes across the San Fernando Valley. Two of the wounded later died, bringing the death toll to 4 people.",2019
1888,2019-07-23,Pembroke Park,Florida,2,2,4,Two men were killed and two others were wounded after an argument between a group escalated into a shooting.,2019
1889,2019-07-21,Chicago,Illinois,0,4,4,"A gunman opened fire on a group of people, wounding four, as they congregated outside of a gas station.",2019
1890,2019-07-21,Washington D.C.,Washington D.C.,0,4,4,"Four people were injured in a shooting, which was captured by surveillance video.",2019
1891,2019-07-20,Chicago,Illinois,0,7,7,"Seven people were wounded in a shooting in Lincoln Park, after an argument between two groups escalated.",2019
1892,2019-07-20,Jersey City,New Jersey,0,6,6,Six people were wounded in an overnight shooting.,2019
1893,2019-07-20,Clairton,Pennsylvania,0,4,4,Four teenagers—between the ages of 14 and 18—were wounded in a shooting at a graduation party.,2019
1894,2019-07-18,Chicago,Illinois,1,3,4,One woman was killed and three people were injured on a porch at a home in Garfield Park in Chicago's West Side.,2019
1895,2019-07-17,Lubbock,Texas,1,3,4,Five men in a vehicle were targeted by a shooter who killed one and injured three others.,2019
1896,2019-07-16,San Antonio,Texas,0,4,4,"A man opened fire on his co-workers at a moving company, injuring four, after a disagreement escalated. The suspect was later arrested.",2019
1897,2019-07-15,Baltimore,Maryl,2,2,4,"A man attempted to use a gun to demand methadone, then killed one and wounded two before being killed by police in a shootout.",2019
1898,2019-07-15,New Orleans,Louisiana,1,3,4,One person was killed and three were wounded in an apartment complex.,2019
1899,2019-07-15,Atlanta,Georgia,0,4,4,Four people were wounded in a shooting after a potential drug deal turns deadly.,2019
1900,2019-07-13,Philadelphia,Pennsylvania,0,7,7,Seven people were wounded in a shooting during a neighborhood basketball game.,2019
1901,2019-07-13,Chicago,Illinois,1,4,5,One person was killed and four were wounded in a drive-by shooting in Chicago's South Side.,2019
1902,2019-07-11,Houston,Texas,0,4,4,"Four suspects got into a gunfight, wounding four teenagers in a common area at an apartment complex.",2019
1903,2019-07-08,Washington D.C.,Washington D.C.,0,4,4,Four perpetrators wounded four men in a shooting outside of a 7-Eleven store.,2019
1904,2019-07-08,Manson,North Carolina,2,2,4,"Two people were killed and two children—16 and 10-years-old, were wounded after a domestic dispute escalated.",2019
1905,2019-07-07,Flint,Michigan,2,4,6,"Six people were shot, two fatally, while in a car at a gas station. Police are looking for two suspects.",2019
1906,2019-07-07,Wichita,Kansas,0,4,4,Four people were wounded in a shooting after a potential argument escalated.,2019
1907,2019-07-07,Chicago,Illinois,0,4,4,Four people were wounded in an early morning shooting in Chicago's Englewood neighborhood.,2019
1908,2019-07-07,Albuquerque,New Mexico,0,4,4,Four people were discovered wounded in a parking lot in the downtown area.,2019
1909,2019-07-06,San Jose,California,0,4,4,"Four people were discovered wounded by police, who responded to a shots fired call; the victims had driven away from the initial scene.",2019
1910,2019-07-06,St. Clair Shores,Michigan,2,2,4,"After a dispute over fireworks, a man shot into a crowd and injured a 12-year-old child and a woman, then barricaded himself in his home. Police discovered him and a woman deceased in the home.",2019
1911,2019-07-06,Charlotte,North Carolina,0,4,4,Four people were shot in a McDonald's parking lot after a dispute involving a rideshare vehicle.,2019
1912,2019-07-05,Boston,Massachusetts,0,6,6,Six people were wounded in Boston's Roxbury neighborhood.,2019
1913,2019-07-05,Reno,Nevada,1,3,4,One person died and three were wounded in a shooting.,2019
1914,2019-07-05,New York City,New York,0,4,4,A gunman opened fire — injuring four people in the East New York neighborhood.,2019
1915,2019-07-05,Gravette,Arkansas,4,0,4,"Four people were found deceased at a home in an apparent murder–suicide. The deaths consisted of two young males, and one middle aged female, not including the perpetrator who killed himself afterwards.",2019
1916,2019-07-05,Chicago,Illinois,0,5,5,Five people were wounded in a shooting in Chicago's Woodlawn community.,2019
1917,2019-07-04,Chicago,Illinois,1,3,4,"One man was killed and three were wounded, after a suspect opened fire from a vehicle.",2019
1918,2019-07-04,Rockford,Illinois,0,4,4,Four people were wounded after an argument escalated.,2019
1919,2019-07-04,Fresno,California,1,3,4,One person was killed and three were injured after gunfire erupted at an Independence Day celebration.,2019
1920,2019-07-04,Los Angeles,California,0,4,4,"Four people, including a 15-year-old girl were wounded, after two perpetrators opened fire in the Historic South-Central neighborhood.",2019
1921,2019-07-03,Katy,Texas,2,3,5,The perpetrator shot and killed his sister and three others at a housewarming party. He later died at a hospital.,2019
1922,2019-07-02,Wellston,Missouri,0,4,4,Four people were injured in a drive-by shooting just before midnight near a local food store.,2019
1923,2019-07-02,Washington Park,Illinois,0,4,4,"A 16-year-old, 12-year-old and an adult were injured when an argument over fireworks escalated. The perpetrator was shot by a by-stander.",2019
1924,2019-07-01,Baltimore,Maryl,0,4,4,"Four women were injured after a suspect opened fire on them, two were discovered by police, the others privately entered the hospital.",2019
1925,2019-06-30,Dallas,Texas,2,2,4,Two teenagers were killed and two were wounded in a drive-by shooting near a playground.,2019
1926,2019-06-30,Yucaipa,California,0,5,5,Five people were wounded after a fight escalated in a mobile home park after a BBQ.,2019
1927,2019-06-30,Bay Shore,New York,0,6,6,Six people were shot at a house party.,2019
1928,2019-06-30,Oakland,California,0,4,4,A 12-year-old boy and two adults were injured in a shooting outside of an apartment complex.,2019
1929,2019-06-29,Chicago,Illinois,0,5,5,Five people were wounded after gunfire broke out at a gathering in the Near West Side neighborhood.,2019
1930,2019-06-29,Baton Rouge,Louisiana,0,7,7,Seven people were injured in a shooting outside of a night club after a fight escalated.,2019
1931,2019-06-29,Hartford,Connecticut,0,4,4,"Police discovered two people wounded, while an additional two were self-transported to area hospitals.",2019
1932,2019-06-28,Paterson,New Jersey,0,4,4,Four people were wounded by gunfire that erupted on a street.,2019
1933,2019-06-28,Saint Paul,Minnesota,0,5,5,Five people were wounded in a shooting.,2019
1934,2019-06-28,Atlanta,Georgia,0,7,7,Seven people were wounded during a drive-by shooting involving two vehicles.,2019
1935,2019-06-28,Hamden,Connecticut,0,5,5,"Five people were wounded in a shooting, after police break up a house party.",2019
1936,2019-06-27,Atlanta,Georgia,0,7,7,"Seven people were wounded, two critically, in a drive-by shooting in the Old Fourth Ward neighborhood.",2019
1937,2019-06-26,Akron,Ohio,1,3,4,"One man was killed and three others, including a boy, were wounded in a home invasion.",2019
1938,2019-06-23,Abbeville,South Carolina,3,1,4,Two people were killed and two were wounded in a shooting at an apartment complex. One of the victims later died at the hospital from their injuries.,2019
1939,2019-06-23,Columbus,Ohio,0,5,5,Five people were wounded in a drive-by shooting outside of a local motorcycle club.,2019
1940,2019-06-23,La Jolla,California,1,3,4,One person was killed and three others were injured after a drive-by shooting at a party.,2019
1941,2019-06-23,South Bend,Indiana,1,10,11,One person was killed and ten were injured after the perpetrator opened fire on a patrons at a local bar.,2019
1942,2019-06-23,San Jose,California,5,0,5,A four-hour standoff ends after a man kills four people then himself.,2019
1943,2019-06-22,Baltimore,Maryl,1,4,5,"A gunman opened fire on a crowd, killing a 19-year-old man and wounding four others.",2019
1944,2019-06-22,Philadelphia,Pennsylvania,0,4,4,Four men were wounded by gunfire in an overnight shooting.,2019
1945,2019-06-22,Hampton,Virginia,0,4,4,Two adults and two children were injured in a shooting at Buckroe Beach.,2019
1946,2019-06-21,Saginaw,Michigan,1,3,4,"Four people were shot, one fatally, at a house on the city's west side.",2019
1947,2019-06-21,Chicago,Illinois,0,4,4,"Four people, including a pregnant woman, were wounded in a shooting outside of the Parkway Garden Homes apartment complex.",2019
1948,2019-06-21,Richmond,California,0,5,5,Five people were wounded in a drive-by shooting.,2019
1949,2019-06-20,Allentown,Pennsylvania,0,10,10,Ten people were injured from gunfire outside of a nightclub.,2019
1950,2019-06-18,Newark,New Jersey,1,6,7,One man was killed and six others were injured after gunfire broke out in two separate locations in the downtown area.,2019
1951,2019-06-17,Dallas,Texas,1,1,2,2019 Dallas courthouse shooting: One person was superficially injured and the perpetrator was killed in a shooting next to the Earle Cabell Federal Building.,2019
1952,2019-06-17,San Antonio,Texas,0,4,4,"Four people were injured from gunfire, after getting into an altercation with another motorist.",2019
1953,2019-06-17,Memphis,Tennessee,0,5,5,Five people were wounded in the parking lot of an apartment complex.,2019
1954,2019-06-16,Philadelphia,Pennsylvania,1,7,8,One person was killed and seven were injured at a graduation party. All of the victims are between 15 and 17 years of age.,2019
1955,2019-06-16,Louisville,Kentucky,1,6,7,Five men and two women were discovered shot near a liquor store by police. One of the men later died at the hospital.,2019
1956,2019-06-16,Des Moines,Iowa,0,6,6,Six people were shot in a drive-by shooting while standing in the street after a party.,2019
1957,2019-06-15,Shreveport,Louisiana,0,4,4,Four people were wounded in a drive-by shooting outside of a nightclub.,2019
1958,2019-06-15,West Des Moines,Iowa,4,0,4,"Three relatives, two children and two adults, were found dead from gunshot wounds in a house.",2019
1959,2019-06-12,Charlotte,North Carolina,1,3,4,An adult male was killed at a party in a rented Airbnb; a teenager and two other adults were injured.,2019
1960,2019-06-11,Savannah,Georgia,2,2,4,Police responded to a scene and discovered two men deceased and two others injured.,2019
1961,2019-06-11,Aurora,Colorado,0,4,4,Four people were wounded in an overnight shooting; the victims were self-transported to the hospital for treatment.,2019
1962,2019-06-09,Cleveland,Ohio,1,3,4,"One person was killed and three wounded, after the perpetrator opened fire on a crowd gathered in Kerruish Park.",2019
1963,2019-06-09,Henning,Tennessee,1,3,4,One was killed and three others were injured in a shooting at a nightclub.,2019
1964,2019-06-09,Buffalo,New York,0,4,4,Four people were injured in a shooting after a dispute.,2019
1965,2019-06-08,White Swan,Washington,5,0,5,Five people were killed after the perpetrator opened fire on the Yakama Indian Reservation.,2019
1966,2019-06-08,Chicago,Illinois,0,4,4,Four people were wounded in the Humbdolt neighborhood after an altercation with the suspect.,2019
1967,2019-06-07,Austin,Texas,0,5,5,"Five people were taken to the hospital after the suspect fired shots at the ground, indirectly wounding them.",2019
1968,2019-06-06,Chicago,Illinois,1,3,4,One man was killed and three others wounded when a secondary vehicle pulled up next to vehicle and opened fire on Lake Shore Drive.,2019
1969,2019-06-05,Santa Rosa,California,0,4,4,"A teenager opened fire at a soccer park, wounding an 11-year-old boy and three others.",2019
1970,2019-06-01,Allendale,South Carolina,0,5,5,Five men were wounded in a shooting at a car wash.,2019
1971,2019-06-01,Portsmouth,Virginia,1,3,4,One person was killed and three were critically injured in an overnight shooting.,2019
1972,2019-06-01,Chicago,Illinois,0,4,4,An adult male and three teenagers were wounded in a shooting in the Austin community of Chicago.,2019
1973,2019-06-01,Chicago,Illinois,0,4,4,Four men were wounded in two separate locations near Northwestern University's Gold Coast campus.,2019
1974,2019-06-01,Atlanta,Georgia,0,5,5,Police discovered three individuals wounded after responding to a shooting; an additional two were transported via personal vehicles to the hospital.,2019
1975,2019-06-01,Macon,Georgia,0,4,4,Three men and a woman were injured after a suspect opened fire at a block party.,2019
1976,2019-05-31,Virginia Beach,Virginia,13,4,17,2019 Virginia Beach shooting: A gunman killed 12 people and injured four others at a city public works building. The gunman died at the scene after being shot by police.,2019
1977,2019-05-30,Robbins,Illinois,0,5,5,Five people were wounded after a vehicle pulled up to a large gathering and opened fire.,2019
1978,2019-05-29,Cleveland,Texas,2,3,5,"A man shot three employees at a local plumbing company, killing one before exchanging gunfire with a sheriff's deputy, also injuring him before committing suicide.",2019
1979,2019-05-27,Trenton,New Jersey,1,5,6,"Police responded to a shooting on Walnut Avenue, and found one teenager deceased and five adults injured.",2019
1980,2019-05-27,Washington D.C.,Washington D.C.,0,5,5,A boy and four others were wounded in a shooting in the Barry Farm neighborhood.,2019
1981,2019-05-26,Washington D.C.,Washington D.C.,1,3,4,One teenager was killed and two women and a child were injured after being shot in a parking lot.,2019
1982,2019-05-26,Chicago,Illinois,2,3,5,"Several people were gathered outside of a party when a man opened fire, killing two and wounding three.",2019
1983,2019-05-26,Stockton,California,1,3,4,Police discovered one person deceased and three injured after responding to reports of a shooting.,2019
1984,2019-05-26,La Crosse,Virginia,0,5,5,"Multiple shooters reportedly opened fire at a block party, injuring five people.",2019
1985,2019-05-25,Chesapeake,Virginia,1,9,10,"Police responded to a noise complaint at a large party, and discovered ten people with gunshot wounds. One later died from their injuries.",2019
1986,2019-05-25,Baltimore,Maryl,0,4,4,"Four people, including a teenager were found shot in McElderry Park.",2019
1987,2019-05-25,Trenton,New Jersey,0,10,10,Ten people were wounded in a shooting at a bar.,2019
1988,2019-05-25,Oklahoma City,Oklahoma,0,5,5,"Five people were wounded in a parking lot, after an SUV pulled up and its occupants began shooting.",2019
1989,2019-05-20,Alexandria,Louisiana,1,4,5,One teenager was killed and five were injured in a shooting.,2019
1990,2019-05-20,Columbus,Ohio,0,4,4,Four people were injured in a shooting in the Hilltop neighborhood.,2019
1991,2019-05-20,Tulsa,Oklahoma,2,2,4,"A man opened fire on a group of people, killing two and wounding two others at an apartment complex.",2019
1992,2019-05-19,Portland,Oregon,0,5,5,Five people were wounded after gunfire erupted at a warehouse party.,2019
1993,2019-05-18,Atmore,Alabama,1,8,9,One person was killed and eight were wounded at a high school graduation party when a gunman opened fire during a fight.,2019
1994,2019-05-18,Winston-Salem,North Carolina,1,5,6,One man was killed and five were wounded at an overnight block party.,2019
1995,2019-05-18,Muncie,Indiana,0,7,7,Seven people were wounded at a house party near the campus of Ball State University.,2019
1996,2019-05-18,Cascilla,Mississippi,1,5,6,One person was killed and five were injured in a shooting during a family dispute.,2019
1997,2019-05-18,Long Beach,California,1,5,6,A 57-year-old woman was killed and five others were wounded during a vigil at a local bar.,2019
1998,2019-05-18,Cedar Rapids,Iowa,2,2,4,Two people were killed and two were wounded after an assailant shot into a vehicle outside of a tobacco store.,2019
1999,2019-05-17,Sacramento,California,1,4,5,"A woman and three others, including a 4-year-old boy were wounded in what police presume was a targeted shooting. One of the victims later died from their injuries.",2019
2000,2019-05-16,Cleveland,Ohio,0,4,4,"Four people, including two teenagers were wounded in a shooting.",2019
2001,2019-05-15,St. Rose,Louisiana,0,4,4,"Four people, including two children were wounded during an altercation between two men in a strip mall parking lot.",2019
2002,2019-05-13,St. Louis,Missouri,4,1,5,"Three people were killed and two were critically injured in a shooting at a home. One victim died of their injuries days later, taking the death toll to four.",2019
2003,2019-05-13,New Orleans,Louisiana,0,4,4,Three men and a teenager were wounded in a drive-by shooting in the Central City neighborhood.,2019
2004,2019-05-11,Chestnuthill Township,Pennsylvania,0,4,4,Four people were wounded in a shooting inside of a residence. The perpetrator was later arrested.,2019
2005,2019-05-11,Paulsboro,New Jersey,0,4,4,"A person began shooting at an event that was originally reported to be a rap concert and subsequently described as a birthday party. Four people were injured by the gunfire, and a fifth person suffered a head injury after falling.",2019
2006,2019-05-10,St. Louis,Missouri,0,6,6,"A shooting was reported near Farragut Elementary School, where two men were discovered wounded, and an additional four were identified at the hospital.",2019
2007,2019-05-10,Philadelphia,Pennsylvania,0,5,5,A large group of adult men were ambushed by three teenagers who came out of a breezeway and shot and injured five of them.,2019
2008,2019-05-08,Indianapolis,Indiana,0,4,4,Four people were wounded in a shooting near the northwest side of Indianapolis.,2019
2009,2019-05-07,Highlands Ranch,Colorado,1,8,9,"STEM School Highlands Ranch shooting: Authorities responded to the STEM School Highlands Ranch, at about 1:50 pm on a report of shots fired. One student was fatally shot and eight others were injured; two suspects were taken into custody by police.",2019
2010,2019-05-05,Oceano,California,0,6,6,Officers responded to a call and discovered six individuals wounded by gunfire; the victims were transported to local hospitals for treatment.,2019
2011,2019-05-05,North Bergen,New Jersey,1,4,5,"Just before 4 am, officers discovered one person deceased and four people wounded, after a fight potentially escalated.",2019
2012,2019-05-04,Indianapolis,Indiana,0,4,4,Three teens and one man were injured after a fight involving between 20 and 30 individuals.,2019
2013,2019-05-04,Wilmington,Delaware,0,4,4,Four people were wounded in a shooting at West 27th and Tatnall Streets.,2019
2014,2019-05-04,St. Louis,Missouri,1,4,5,Five people were shot inside of a vehicle; the incident resulted in one death and four injuries.,2019
2015,2019-05-03,Baltimore,Maryl,0,4,4,Four people were injured and discovered after a Shot Spotter gunfire alert notified police to the location.,2019
2016,2019-05-03,Baltimore,Maryl,0,5,5,"Emergency responders discovered a female and two young children injured, and two men were later identified as being wounded in the same incident.",2019
2017,2019-05-03,Dallas,Texas,1,3,4,Four men were discovered shot at Cherrywood Park after a drive-by shooting; one of the victims died from their injuries.,2019
2018,2019-05-01,Boston,Massachusetts,1,3,4,One person was killed and three were wounded while sitting in a parked car in Boston's Dorchester neighborhood.,2019
2019,2019-04-30,Charlotte,North Carolina,2,4,6,"University of North Carolina at Charlotte shooting: Six people were shot, two fatally, on the last day of classes at the University of North Carolina at Charlotte. The student gunman was taken into custody after he was tackled by one of the students in the classroom. He had several more loaded magazines in a backpack.",2019
2020,2019-04-28,Nashville,Tennessee,0,7,7,Two men got into an altercation at a party and exchanged gunfire; seven people were wounded in the crossfire.,2019
2021,2019-04-28,West Chester Township,Ohio,4,0,4,"Four family members, three women and one man, were found shot to death in an apartment. The suspect remains at large.",2019
2022,2019-04-28,Birmingham,Alabama,0,4,4,"A suspect in a vehicle opened fire on patrons outside of a nightclub, injuring four.",2019
2023,2019-04-28,Baltimore,Maryl,1,7,8,One person was killed and seven were wounded when a gunman opened fire on two cookouts at an intersection.,2019
2024,2019-04-27,Jackson,Michigan,0,4,4,Four people were wounded in an overnight shooting.,2019
2025,2019-04-27,Jackson,Mississippi,1,3,4,One person was killed and three were injured in a shooting in south Jackson.,2019
2026,2019-04-27,Poway,California,1,3,4,Poway synagogue shooting: One person was killed and at least three were wounded by a shooter at the Chabad of Poway synagogue.,2019
2027,2019-04-26,Hugo,Oklahoma,0,4,4,"Investigators attempted to make contact with the suspect in relation to another crime, he then began to open fire, injuring three children and himself.",2019
2028,2019-04-21,Philadelphia,Pennsylvania,0,4,4,Four people were wounded in the Grays Ferry Section of the city.,2019
2029,2019-04-21,Los Angeles,California,0,4,4,Four seniors were wounded by gunfire after a suspect opened fire in the vehicle behind them.,2019
2030,2019-04-20,Corpus Christi,Texas,0,4,4,A disturbance in a neighborhood escalated into a shooting; four men were wounded.,2019
2031,2019-04-20,Memphis,Tennessee,0,7,7,Seven people were wounded in a shooting that police believe occurred after a large fight.,2019
2032,2019-04-19,Wichita,Kansas,0,4,4,"Two suspects fired multiple shots at people attending a party, injuring four.",2019
2033,2019-04-18,Louisville,Kentucky,0,4,4,Four people in a vehicle were wounded when they were shot at by at least one person in another car.,2019
2034,2019-04-16,Germantown,Maryl,1,3,4,A drive-by shooting killed an 18-year-old male and wounded three other men in a cul-de-sac.,2019
2035,2019-04-14,Stockton,California,0,4,4,"A man opened fire inside of a bar following a disturbance, wounding four patrons.",2019
2036,2019-04-14,Miami,Florida,2,2,4,Two women were killed and another man and woman were wounded in a drive-by shooting outside of Miami's Liberty City neighborhood.,2019
2037,2019-04-14,Valleho,California,1,3,4,One man was killed and three were injured in an early morning shooting.,2019
2038,2019-04-12,Carbondale,Illinois,0,4,4,Four people were injured in a shooting outside of a restaurant and bar.,2019
2039,2019-04-11,Phoenix,Arizona,3,2,5,"A man killed his wife, two of his daughters, and another man, and injured two people who came to try to help one of the victims. All of the victims were shot, with the exception of one of his daughters who was killed by blunt force trauma.",2019
2040,2019-04-11,Los Angeles,California,1,4,5,One person was killed and four were wounded when suspects fired at them from a car in the Watts neighborhood of Los Angeles.,2019
2041,2019-04-11,Baltimore,Maryl,0,4,4,Four men were wounded in a shooting near Druid Hill Park.,2019
2042,2019-04-09,Kansas City,Missouri,0,4,4,Police found four people with gunshot wounds in front of a residence.,2019
2043,2019-04-07,Shreveport,Louisiana,0,4,4,Four people were wounded in a shooting at a mobile home park.,2019
2044,2019-04-07,Indianapolis,Indiana,2,3,5,Two people were killed and three were wounded in a shooting at a motorcycle club hangout.,2019
2045,2019-04-07,Winston-Salem,North Carolina,0,6,6,Six people were wounded in a shooting outside of a local bar.,2019
2046,2019-04-07,Wilmington,Delaware,0,6,6,Six young men were wounded in a shooting in the city's East Side district.,2019
2047,2019-04-06,Chicago,Illinois,0,6,6,At least six people were injured in a shooting at a baby shower.,2019
2048,2019-04-06,Tallahassee,Florida,0,4,4,Four Florida A&M University students were injured in a shooting following an argument at a house party.,2019
2049,2019-04-04,Stockbridge,Georgia,3,2,5,Two officers responding to a suspected hostage situation were wounded and three individuals were later found deceased in a murder–suicide.,2019
2050,2019-04-04,Panama City,Florida,1,3,4,One person was killed and three were found with gunshot injuries in Panama City.,2019
2051,2019-04-02,Covington,Kentucky,0,5,5,Five people were wounded in a drive-by shooting at an intersection.,2019
2052,2019-04-02,Hermanville,Mississippi,0,4,4,A man shot four people in a drive-by shooting outside of a convenience store.,2019
2053,2019-03-31,Chicago,Illinois,1,4,5,One person was killed and four people were wounded in a shooting in East Garfield Park.,2019
2054,2019-03-31,Atlanta,Georgia,1,4,5,One person was killed and four were wounded during a house party.,2019
2055,2019-03-31,North Charleston,South Carolina,0,7,7,Seven people were wounded in a shooting at an overnight house party.,2019
2056,2019-03-28,Baltimore,Maryl,0,4,4,Four people were wounded in a shooting near a playground.,2019
2057,2019-03-25,North Las Vegas,Nevada,0,5,5,An after-school fight led to a shooting in a neighborhood; five teenagers were wounded.,2019
2058,2019-03-24,Phoenix,Arizona,0,7,7,"During a warehouse party, a fight broke out and escalated into a shooting; seven people were wounded.",2019
2059,2019-03-24,San Francisco,California,1,5,6,A shooting occurred near the Fillmore Heritage Center around 8:40 pm local time; one person was killed and five others were injured.,2019
2060,2019-03-19,Phoenix,Arizona,2,4,6,An argument at a house party ended in a shooting when the perpetrator returned to the party and killed two and wounded four before fleeing.,2019
2061,2019-03-17,Augusta,Georgia,0,4,4,"Four people were wounded after an argument, although the shooter claims that it was in self-defense to being randomly attacked.",2019
2062,2019-03-17,Las Vegas,Nevada,0,4,4,Four people were wounded at the El Cortez Hotel and Casino in an early morning shooting. The suspect was later arrested.,2019
2063,2019-03-17,Rochelle,Georgia,1,3,4,"In the early morning, two groups were involved in a dispute, which ended with one person killed and three people wounded.",2019
2064,2019-03-16,Camden,New Jersey,1,3,4,"One man was killed and three others were wounded following a shooting at a ""residential speakeasy"".",2019
2065,2019-03-15,Mobile,Alabama,2,3,5,Two men were killed and three others were wounded in an overnight shooting behind a home. The suspect was arrested the next day.,2019
2066,2019-03-14,Missoula,Montana,1,3,4,"One person was fatally shot and three others were wounded, including a Montana Highway Patrol trooper following a road rage incident.",2019
2067,2019-03-13,Harvey,Illinois,1,3,4,One person was killed and three were wounded after gunfire erupted in a nightclub.,2019
2068,2019-03-11,Paterson,New Jersey,0,4,4,Four men were wounded in a shooting inside of a local liquor store.,2019
2069,2019-03-10,Denver,Colorado,1,4,5,"A conflict between two individuals escalated into a shooting; one man was killed, and four others were injured.",2019
2070,2019-03-10,Shreveport,Louisiana,0,4,4,Three children and one adult were wounded in a drive-by shooting.,2019
2071,2019-03-03,Oakland,California,0,4,4,Four people were injured in a shooting at a sports bar following a fight.,2019
2072,2019-03-03,Chicago,Illinois,0,6,6,Six people were injured in a shooting at a bar following a fight.,2019
2073,2019-03-02,Pine Bluff,Arkansas,1,4,5,One person was killed and four other were wounded at a party when shots were fired into a home.,2019
2074,2019-02-28,Joliet,Illinois,4,0,4,Two adults and their 6 and 1-year-old children were killed in an apparent murder suicide.,2019
2075,2019-02-28,Oakland,California,1,4,5,One person was killed and four others were wounded in a shooting near a gas station.,2019
2076,2019-02-22,Birmingham,Alabama,2,2,4,Two people were killed and two were injured in a shooting at a party in a home.,2019
2077,2019-02-21,Elizabeth,Kentucky,2,2,4,Two people were killed and two others were found wounded in two separate shootings believed to be perpetrated by the same man.,2019
2078,2019-02-21,Baltimore,Maryl,1,4,5,"Officers on patrol responded to gunshots, and upon investigation discovered a deceased male and four wounded victims.",2019
2079,2019-02-21,Houston,Texas,2,2,4,A gunman perched on the roof of a home killed two and wounded two after an argument led to the incident.,2019
2080,2019-02-20,Covington,Tennessee,0,4,4,Three adults and a teenager were injured inside a home in a presumed targeted shooting.,2019
2081,2019-02-18,Solon Township,Michigan,4,0,4,"A 28-year-old woman killed her three children, ages 8, 6 and 2, before killing herself.",2019
2082,2019-02-17,New Orleans,Louisiana,1,5,6,"After police attempted to arrest a suspect, a gunfight broke out, and led to one person being killed and five being wounded.",2019
2083,2019-02-17,Henderson,Texas,2,2,4,"Two people were wounded and two were killed in a shooting at an apartment complex. The suspect was later arrested in Bienville Parish, Louisiana.",2019
2084,2019-02-17,Evansville,Indiana,0,5,5,Five people were wounded after shots were fired outside of a bar. Two suspects were taken into custody by police.,2019
2085,2019-02-16,Clinton,Mississippi,4,0,5,"Police responded to a domestic dispute at a residence; upon arrival, the suspect fired shots at officers leading to a 12-hour hostage standoff. Four people were killed, and the suspect was taken into custody and later died.",2019
2086,2019-02-15,Aurora,Illinois,6,6,12,"Aurora, Illinois shooting: A man opened fire in his workplace, killing five employees, and injuring five police officers and a civilian before being killed by police.",2019
2087,2019-02-14,Jacksonville,Florida,2,2,4,"After a fight broke out near a basketball court at a park, multiple people started shooting at each other. Two people were killed, and two were wounded.",2019
2088,2019-02-11,Livingston,Texas,5,0,5,"A family member heard sounds of gunfire, and upon investigation, found four adults and one toddler deceased.",2019
2089,2019-02-09,Petersburg,Virginia,0,4,4,Four people were injured in a shooting outside of an apartment complex.,2019
2090,2019-02-06,Cleveland,Ohio,1,3,4,One man was killed and three others were injured after a shooting broke out in Cleveland's Clark–Fulton neighborhood.,2019
2091,2019-02-06,New York City,New York,1,3,4,A man was killed and three others were injured after a shooting in the lobby of an apartment building around 10:30 pm ET.,2019
2092,2019-02-05,San Antonio,Texas,2,2,4,"A man and woman were killed and two others injured after the shooter kicked open an apartment door and shot inside, before fleeing.",2019
2093,2019-02-04,Washington D.C.,Washington D.C.,0,5,5,Four men and an elementary-school-age girl were injured in a shooting at a bus stop.,2019
2094,2019-02-04,Baton Rouge,Louisiana,0,4,4,Four people were wounded in an early morning shooting.,2019
2095,2019-02-03,Chicago,Illinois,2,5,7,"Around 2 am local time, two people were killed and five people were wounded in a drive-by shooting after a fight outside of a club.",2019
2096,2019-02-01,San Diego,California,0,4,4,A fight broke out at a house party and shots were fired; four people were wounded.,2019
2097,2019-01-28,Houston,Texas,2,4,6,Pecan Park Raid: Four police officers were shot while serving a warrant in southeast Houston. The two homeowners were killed.,2019
2098,2019-01-27,Birmingham,Alabama,0,5,5,"Police responded to a call and discovered five people with gunshot wounds, along with two of the victims sustaining life-threatening injuries.",2019
2099,2019-01-26,Albany,Georgia,0,4,4,"Two people were found with bullet wounds in front of a residence, and two more arrived at a hospital with gunshot injuries from the same shooting.",2019
2100,2019-01-26,Indianapolis,Indiana,0,5,5,"A man was asked to leave a bar; shortly after, he came back and shot five people, critically wounding two.",2019
2101,2019-01-26,Newark,New Jersey,1,3,4,"A gunman opened fire on individuals attending a candlelight vigil, killing one, and wounding three others.",2019
2102,2019-01-26,Ascension Parish and Livingston Parish,Louisiana,5,0,5,"January 2019 Louisiana shootings: A 21-year-old man killed five people, including his parents, in two parishes in Louisiana. The suspect fled to Virginia and was arrested the next day.",2019
2103,2019-01-24,State College,Pennsylvania,4,1,5,"A man killed two people and injured one inside a local bar, then drove away and broke into a home and killed the homeowner before killing himself.",2019
2104,2019-01-24,Rockmart,Georgia,4,1,5,A man killed four individuals and injured another in two separate shootings.,2019
2105,2019-01-23,Sebring,Florida,5,0,5,2019 Sebring shooting: At least five people were killed in a hostage incident and shooting at a bank. The suspect was taken into custody by police.,2019
2106,2019-01-20,Miami,Florida,0,4,4,Three adults and a child were wounded in a shooting while attending a block party.,2019
2107,2019-01-19,Houston,Texas,3,2,5,Three people were killed and two more were injured by a homeowner in a possible attempted home invasion.,2019
2108,2019-01-19,Gaffney,South Carolina,1,4,5,One person was killed and four others were wounded in a shooting at a nightclub.,2019
2109,2019-01-19,Jacksonville,Florida,3,2,5,A man killed two people and injured two more before killing himself.,2019
2110,2019-01-19,Lebanon,Pennsylvania,0,4,4,"In an apparent targeted shooting, four individuals were discovered shot in a building.",2019
2111,2019-01-19,Chicago,Illinois,0,4,4,"Early in the morning, three women and a man were involved in a fight and were injured in the ensuing shooting.",2019
2112,2019-01-17,Owensboro,Kentucky,3,1,4,Three people were killed and another person was wounded in a shooting at a home. Two men were arrested in relation to the shooting.,2019
2113,2019-01-16,Jacksonville,Florida,1,5,6,"A man was killed and five other people were injured in a shooting. The Mayor of Jacksonville described the shooting as gang-related, although this characterization has been disputed by the sister of the deceased man.",2019
2114,2019-01-16,Palmdale,California,3,1,4,Three people were killed and another one was wounded in a shooting.,2019
2115,2019-01-15,Little Rock,Arkansas,1,4,5,"An argument over a gun inside a local ice cream shop led to a shooting. One man was killed and four others, including the suspected shooter, were injured.",2019
2116,2019-01-13,Phoenix,Arizona,1,5,6,"An argument at a motel escalated into a shooting. One person was killed, and five others were injured.",2019
2117,2019-01-06,Roswell,New Mexico,0,4,4,A man injured four people in a shooting following an argument at a party. He was arrested the same day.,2019
2118,2019-01-04,Torrance,California,3,4,7,"An argument at the Torrance bowling alley escalated into a fight and three people were killed by gunshots, at least four others were wounded. A suspect who was out of prison on parole has been arrested.",2019
2119,2019-01-04,Hurt,Virginia,3,2,5,A man killed his wife and son in their home and injured two people who were inside a vehicle before killing himself.,2019
2120,2019-01-04,Houston,Texas,1,3,4,A man injured his brother and two friends before being killed by a police officer.,2019
2121,2019-01-03,Texas City,Texas,3,1,4,Three children under the age of six were found deceased along with a wounded woman in an apparent home invasion.,2019
2122,2019-01-02,Jonesboro,Arkansas,1,3,4,A 16-year-old boy was killed and three others were wounded during a home invasion.,2019
2123,2019-01-01,Tallahassee,Florida,0,5,5,Five people were shot and wounded around 3am local time at the University Village Shopping Center.,2019
2124,2019-01-01,Columbia,South Carolina,0,5,5,Five people were shot and wounded outside of a nightclub around 6am local time.,2019
2125,2018-12-31,Cleveland,Ohio,3,2,5,A dispute began at a rented Airbnb during a New Year's Eve party. Three men were killed and another man and woman were wounded.,2018
2126,2018-12-29,Lima,Ohio,1,3,4,One person was killed and three people were wounded in a shooting at an afterhours club.,2018
2127,2018-12-28,St. Charles,Missouri,4,1,5,"A gunman shot and killed his girlfriend, her two children, and her mother. He was arrested after exchanging fire with police and attempting to carjack a vehicle.",2018
2128,2018-12-24,Lutcher,Louisiana,2,2,4,Three people were killed and two others were wounded in a shooting outside of a bar.,2018
2129,2018-12-23,Springfield,Missouri,0,7,7,Seven people were wounded during a shooting at a holiday party.,2018
2130,2018-12-22,Las Vegas,Nevada,0,4,4,Four people were wounded during a shooting at a holiday party.,2018
2131,2018-12-18,Baltimore,Maryl,0,5,5,Five people were injured in a shooting outside a deli.,2018
2132,2018-12-15,Miami,Florida,0,5,5,Five people were wounded in a shooting.,2018
2133,2018-12-14,Colorado Springs,Colorado,1,3,4,One person was killed and three others were injured in a shooting near the Colorado Springs Airport.,2018
2134,2018-12-13,Philadelphia,Pennsylvania,0,4,4,Four men were injured in a shooting that occurred inside a barbershop. The suspect evaded police but the weapon was recovered.,2018
2135,2018-12-11,Natachitoches,Louisiana,1,3,4,One person was killed and three others were wounded in a shooting just before midnight.,2018
2136,2018-12-09,Madison,Wisconsin,0,4,4,Four people were injured by gunfire inside a strip club following a fight. One additional person was stabbed.,2018
2137,2018-12-09,Laurinburg,North Carolina,1,3,4,One person was killed and three others were wounded in a shooting.,2018
2138,2018-12-08,New York City,New York,0,5,5,Five people were wounded outside of a nightclub in Queens after a dispute inside the club.,2018
2139,2018-12-01,Miami,Florida,0,5,5,Five people were wounded in a shooting in the Overtown neighborhood of Miami.,2018
2140,2018-11-26,Powell,Tennessee,0,4,4,Four people were wounded in a shooting. Two suspects were taken into custody by police.,2018
2141,2018-11-25,Houston,Texas,1,6,7,"A thirteen-year-old boy was killed and six other people were injured in a shooting at a block party. At least two shooters were involved, and police believe it may have been gang-related.",2018
2142,2018-11-25,Demopolis,Alabama,2,2,4,Two people were killed and two others were wounded in a shooting at an intersection.,2018
2143,2018-11-25,Oakland,California,0,4,4,Four people were wounded in a drive-by shooting while attending a vigil for a resident of their area who had died of natural causes.,2018
2144,2018-11-24,Orlando,Florida,2,2,4,Two people were killed and two others were wounded in a shooting outside a pizza shop. A suspect was taken into custody by police.,2018
2145,2018-11-23,Miami,Florida,2,2,4,"Two people were killed and five others were wounded in a shooting outside of a convenience store. Two of the injured were hit with bullets, the other three were injured in other ways.",2018
2146,2018-11-22,Fort Wayne,Indiana,3,2,5,"Three people were killed and two others were injured in a home invasion shooting. One person was arrested the next day, and police suspect another person was involved.",2018
2147,2018-11-21,St. Louis,Missouri,0,4,4,Four people were injured in a shooting in the Penrose neighborhood of St. Louis.,2018
2148,2018-11-19,Philadelphia,Pennsylvania,4,0,4,Four people were discovered shot execution style in the head in a basement of a home.,2018
2149,2018-11-19,Chicago,Illinois,4,0,4,"Mercy Hospital shooting: A gunman opened fire in the Mercy Hospital and Medical Center in Chicago, killing a doctor at the hospital who was his former fiancée, a police officer, and one other person before being killed either by himself or by police.",2018
2150,2018-11-19,Denver,Colorado,1,3,4,One person was killed and three others were injured in a shooting in the LoDo neighborhood.,2018
2151,2018-11-18,Los Angeles,California,1,3,4,"A man killed his girlfriend and wounded his uncle and grandmother in a shooting in Watts, Los Angeles. The shooter was also injured, either during a confrontation with police or by a self-inflicted gunshot.",2018
2152,2018-11-16,Little Rock,Arkansas,3,1,4,"Police found a boy suffering from gunshot injuries, then discovered a car that had crashed into a ditch. Inside the car were three people who had all been shot and killed.",2018
2153,2018-11-16,Wheatland,Wisconsin,1,3,4,"Two people were shot inside a home, and two others were shot at a gas station. One of the victims later died of their injuries.",2018
2154,2018-11-14,Baton Rouge,Louisiana,3,1,4,Three people were killed and one person was injured in a shooting.,2018
2155,2018-11-13,Indianapolis,Indiana,2,2,4,A man killed two people and wounded two others after shooting them during what police believe to be a drug robbery. One of the deceased men is suspected to have been the perpetrator.,2018
2156,2018-11-13,Tsayatoh,New Mexico,4,1,5,A person killed three people and injured a fourth before killing themself in a residence in an apparent murder–suicide.,2018
2157,2018-11-12,Dunn,North Carolina,3,1,4,A man killed three people and injured one in a shooting after a fight at a home. The shooter was arrested after crashing a vehicle he stole from the scene.,2018
2158,2018-11-11,Robbins,Illinois,1,4,5,"Shooting of Jemel Roberson: A man re-entered a bar after being ejected and began to fire, wounding three people and becoming injured himself. Armed security guards apprehended the suspect. Responding officers saw one of the security guards with a gun, and shot and killed him.",2018
2159,2018-11-11,Globe,Arizona,3,3,5,Three people were killed and one injured when a man began firing at 5 individuals at a bar following a pool game. The suspect was arrested.,2018
2160,2018-11-10,Memphis,Tennessee,2,4,6,Two people were killed and four people were wounded when they were shot after an argument over gambling.,2018
2161,2018-11-07,Thousand Oaks,California,13,16,29,"Thousand Oaks shooting: A man entered a bar hosting a student line-dancing event and killed twelve people, including a police officer. Sixteen other people were injured, one of them by gunfire. The gunman then killed himself.",2018
2162,2018-11-03,Watertown,New York,0,5,5,Five people were wounded in a shooting outside of a nightclub. The suspect was taken into custody by police.,2018
2163,2018-11-02,Tallahassee,Florida,3,5,8,"2018 Tallahassee shooting: A gunman killed two women and injured five others; four by gunfire, one by being pistol-whipped, at a yoga studio before killing himself in a murder–suicide.",2018
2164,2018-11-02,Long Beach,California,0,4,4,Four people were injured in a shooting in North Long Beach. Police suspect the incident was gang-related.,2018
2165,2018-11-01,Minneapolis,Minnesota,0,5,5,An argument evolved into a shooting that left five people wounded.,2018
2166,2018-11-01,Springfield,Missouri,2,2,4,Two men were killed and two other people were wounded in a shooting at a home.,2018
2167,2018-10-31,Detroit,Michigan,1,3,4,A fifteen-year-old boy was killed and three other people were wounded in a shooting at a home after a robbery.,2018
2168,2018-10-30,Los Angeles,California,0,5,5,Five people were injured in a drive-by shooting in South Los Angeles.,2018
2169,2018-10-30,Vallejo,California,2,3,5,Two people were killed and three others were wounded in a shooting.,2018
2170,2018-10-29,Riverside,California,0,7,7,Seven people were wounded in a shooting following a fight at a nightclub.,2018
2171,2018-10-28,El Dorado,Arkansas,2,2,4,Two people were killed and two were injured in a shooting at a home.,2018
2172,2018-10-27,Pittsburgh,Pennsylvania,11,6,17,"Pittsburgh synagogue shooting: A man opened fire in the Tree of Life synagogue in an antisemitic attack, killing eleven people and injuring six others . The suspect was taken into custody by police.",2018
2173,2018-10-27,Memphis,Tennessee,0,5,5,Five people were wounded by several shooters at a high school Halloween party.,2018
2174,2018-10-26,Jersey City,New Jersey,1,3,4,A seventeen-year-old was killed and three other people were wounded in a shooting.,2018
2175,2018-10-24,Chicago,Illinois,0,5,5,Several gunmen wounded five people who were standing on a sidewalk.,2018
2176,2018-10-22,Chicago,Illinois,0,6,6,"Six people were injured at a funeral service for Vantrease Criss, a rapper who was killed a week before.",2018
2177,2018-10-21,Lakewood,Washington,1,3,4,One person was killed and three were wounded after three gunmen began shooting at a nightclub following an argument.,2018
2178,2018-10-21,Jacksonville,Florida,0,6,6,Six people were injured in a drive-by shooting before an NFL game between the Houston Texans and the Jacksonville Jaguars. Those injured were between the ages of 20 and 70.,2018
2179,2018-10-16,Atlanta,Georgia,0,4,4,Four people were injured in a drive-by shooting.,2018
2180,2018-10-15,Columbia,Tennessee,5,0,5,A mother and four teenage children were found by an older brother in an apparent murder–suicide in which the mother is the reported perpetrator.,2018
2181,2018-10-14,North Las Vegas,Nevada,3,1,4,Three people were killed and one was wounded after someone arguing with them outside a shopping center shot them and fled.,2018
2182,2018-10-14,East Palo Alto,California,2,2,4,Two people were killed and two were injured in a shooting outside of a Halloween party.,2018
2183,2018-10-14,Fort Worth,Texas,0,4,4,Two children and two adults were injured in a drive-by shooting.,2018
2184,2018-10-13,St. Louis,Missouri,0,4,4,Four people were wounded near Glasgow Village when one or more people shot into a home.,2018
2185,2018-10-13,Taft,Texas,4,1,5,"A dispute at a one-year-olds birthday party, resulted in four men killed and one wounded.",2018
2186,2018-10-12,Spartanburg,South Carolina,0,6,6,Six people were injured in a shooting at a fast food restaurant. One suspect was arrested and another turned himself in to police. A third person is also suspected of being involved.,2018
2187,2018-10-12,Las Vegas,Nevada,0,4,4,Four people were wounded after being shot in central Las Vegas.,2018
2188,2018-10-08,Birmingham,Alabama,0,4,4,Four people were injured when a person in a vehicle fired shots at them at an apartment complex.,2018
2189,2018-10-06,Oakland,California,0,6,6,"Two men began shooting during a dispute, injuring six people in total including each other. Both men were arrested.",2018
2190,2018-10-06,Tulsa,Oklahoma,0,4,4,"A man fired into a crowd outside a bar during a fight, injuring four people. Another person fired a gun into the air to try to stop the fight, but did not injure anyone.",2018
2191,2018-10-06,Houston,Texas,1,3,4,"People began firing from a vehicle at people in a gas station parking lot, killing one person in a vehicle and wounding three others. The shooting is suspected to be gang-related.",2018
2192,2018-10-04,Swainsboro,Georgia,0,4,4,Four people were wounded when they were injured in a gang-related shooting.,2018
2193,2018-10-04,Española,New Mexico,1,3,4,"Several people began firing at teenagers in a car, killing one and wounding three. Police believe they were targeting people with whom they had been in a dispute on social media, and that the teenagers were mistakenly targeted. Seven suspects were arrested on various charges related to the shooting, including three people charged with first-degree murder.",2018
2194,2018-10-03,Philadelphia,Pennsylvania,1,4,5,One person was killed and four others were injured in a drive-by shooting outside of a store.,2018
2195,2018-10-03,Florence,South Carolina,2,6,8,"Florence, South Carolina shooting: Officers were shot at during a two-hour standoff while attempting to execute a search warrant in which the perpetrator held children hostage, killing two and wounding six before being arrested.",2018
2196,2018-10-01,Chicago,Illinois,2,2,4,"A man began firing a gun inside a vehicle, killing two passengers and wounding another passenger and the driver. He was arrested.",2018
2197,2018-09-24,Memphis,Tennessee,3,2,5,"A fight at an apartment complex, reportedly got out of control and three people were killed and two women wounded.",2018
2198,2018-09-21,Aberdeen,Maryl,4,3,7,"Aberdeen, Maryland Shooting: An employee of the Rite Aid Distribution facility killed three victims before wounding herself. The shooter died later in the hospital.",2018
2199,2018-09-20,Masontown,Pennsylvania,1,4,5,A gunman opened fire in a municipal building and wounded four people before being shot by officer who responded to the incident.,2018
2200,2018-09-20,Middleton,Wisconsin,1,3,4,"A gunman opened fire at the WTS Paradigm software company and wounded three people. The gunman was injured in a shootout with the police, and later died in the hospital.",2018
2201,2018-09-17,Silver Spring,Maryl,4,1,5,"A father shot and killed his wife and two children, and injured his adult stepdaughter, before he committed suicide.",2018
2202,2018-09-13,Bakersfield,California,6,0,6,"A gunman opened fire at three locations after following a witness to another store and then to a private home. He killed two women and three men before carjacking a woman and child, and committing suicide when police approached.",2018
2203,2018-09-06,Cincinnati,Ohio,4,2,6,"Fifth Third Center Shooting: A gunman entered a loading dock at the Fifth Third Center skyscraper and opened fire before entering the lobby of a building. Four people, including the shooter, were killed and two were injured.",2018
2204,2018-09-02,San Bernardino,California,0,8,8,Eight people were wounded during a shooting at a dice game at an apartment complex.,2018
2205,2018-09-01,Cleveland,Ohio,1,7,8,Eight people were shot at a nightclub. Police arrived and found a woman with a gunshot wound to the head at the back of the bar. She later died at a hospital.,2018
2206,2018-08-27,Pine Bluff,Arkansas,1,3,4,"An unidentified individual fired from a vehicle on a group of people standing outside a home, killing one and injuring three.",2018
2207,2018-08-26,Jacksonville,Florida,3,11,14,"Jacksonville Landing Shooting: A gunman killed two people and wounded eleven more at a Madden NFL 19 competition before killing himself. The shooter was identified as David Katz, an individual who had reportedly been eliminated from the competition before the shooting.",2018
2208,2018-08-26,Wichita Falls,Texas,1,3,4,"One person was killed and three others were wounded inside a residence. Authorities took a man into custody in connection with the shooting. According to reports, the deceased victim was shot in the chest.",2018
2209,2018-08-25,Nashville,Tennessee,1,4,5,Two gunmen reportedly shot five people outside a residence. One victim was shot in the chest and later died at Vanderbilt University Medical Center.,2018
2210,2018-08-25,Richmond,Virginia,0,6,6,"Five people were shot and wounded during an armed robbery of Liquid Café. One other individual had an unspecified injury ""by other means"" than gunfire.",2018
2211,2018-08-23,Philadelphia,Pennsylvania,0,4,4,Four people were injured during a shooting in the Oxford Circle neighborhood of Philadelphia.,2018
2212,2018-08-22,St. Louis,Missouri,0,4,4,"A rapper's tour van ""came under fire"" on I-64 after a concert at around 11:05 PM. Four people were injured. It's not clear if the rapper himself was shot.",2018
2213,2018-08-21,Memphis,Tennessee,0,6,6,"Six people were wounded by gunfire in a shooting outside of an apartment complex, following a large fight in the same location the previous day. One of the wounded men was arrested, but charges against him were later dropped.",2018
2214,2018-08-20,Jackson,Tennessee,1,4,5,Five people were injured in a shooting at a bar. One of the victims later died of his injuries.,2018
2215,2018-08-20,Cleveland,Ohio,1,3,4,A fight over drugs resulted in one person being killed and three others being wounded.,2018
2216,2018-08-19,Chicago,Illinois,0,5,5,Five were wounded in a shooting after a softball game in the Grand Crossing neighborhood of Chicago.,2018
2217,2018-08-19,Detroit,Michigan,1,3,4,One person was killed and three others were wounded in a drive-by shooting at a family gathering.,2018
2218,2018-08-18,New York City,New York,0,4,4,Four people were injured during gunfire during a drive-by shooting following a fight in a Bronx lounge.,2018
2219,2018-08-18,Trenton,New Jersey,0,5,5,"Four people were wounded by gunfire following an event where school supplies were distributed to children. A fifth person, a child, received minor injuries after being struck by a dirt bike operated by one of the attackers.",2018
2220,2018-08-17,Chicago,Illinois,0,7,7,Seven people were wounded in a shooting in the Englewood neighborhood of Chicago.,2018
2221,2018-08-15,Greenwood,South Carolina,0,5,5,Five people were injured when they were shot during a backyard gathering to mourn the death of a family member who had died in a car accident earlier that month.,2018
2222,2018-08-14,Wyncote,Pennsylvania,0,5,5,"After a dispute at a grocery store checkout line, a man pulled a handgun from his sister's waistband and wounded five people. The suspect was arrested.",2018
2223,2018-08-12,Clearlake,California,4,1,5,A father killed three of his children and wounded the fourth before killing himself.,2018
2224,2018-08-12,Pittsburgh,Pennsylvania,0,4,4,A woman shot and injured four people in a street fight in the East Liberty neighborhood of Pittsburgh. She later turned herself in to police.,2018
2225,2018-08-11,San Francisco,California,1,4,5,One person was killed and four others were shot in an early-morning shooting in the Crocker-Amazon neighborhood of San Francisco.,2018
2226,2018-08-11,Thornton,Colorado,1,3,4,"After being kicked out of a sports bar following several fights, a man returned with a gun and killed a bartender. Three others were wounded by gunfire. The shooter was taken into custody.",2018
2227,2018-08-11,Columbus,Ohio,0,4,4,Two adults and two children were wounded in a shooting at a party at a park in north Columbus.,2018
2228,2018-08-10,Detroit,Michigan,0,4,4,Four people were wounded by a gunman who was later taken into custody.,2018
2229,2018-08-10,St. Louis,Missouri,0,4,4,A man wounded four people at a gas station after shooting at them from his truck. He was arrested by police.,2018
2230,2018-08-08,Philadelphia,Pennsylvania,2,4,6,Two people were killed and four were injured in a drive-by shooting in North Philadelphia.,2018
2231,2018-08-08,Paterson,New Jersey,0,4,4,Four people were wounded by a gunman.,2018
2232,2018-08-05,Chicago,Illinois,0,4,4,Four people were wounded at Humboldt Park when they were shot at by two people in a car.,2018
2233,2018-08-05,Chicago,Illinois,0,8,8,Eight people were wounded when a group of men approached them in a courtyard and began shooting.,2018
2234,2018-08-05,Chicago,Illinois,0,4,4,Four people were wounded by gunfire at a house party.,2018
2235,2018-08-05,Chicago,Illinois,1,5,6,Two shooters killed one person and wounded five others when they began shooting at a group standing on a sidewalk.,2018
2236,2018-08-05,Chicago,Illinois,1,4,5,One person was killed and four were injured in the Austin neighborhood of Chicago.,2018
2237,2018-08-04,North Las Vegas,Nevada,0,6,6,Six people were injured during a shooting at a house party.,2018
2238,2018-08-04,Kansas City,Missouri,0,6,6,Six people were shot when a man pulled a handgun from his waistband during a fight. The suspect was taken into custody.,2018
2239,2018-08-04,Milwaukee,Wisconsin,0,4,4,Four people were injured when a gunman began shooting from a car at a group of people who were grilling and playing basketball in a park.,2018
2240,2018-08-04,Chicago,Illinois,1,3,4,One person was killed and three were injured in the Austin neighborhood of Chicago.,2018
2241,2018-07-31,Gardena,California,2,3,5,"After becoming upset at a party, a man killed one person and wounded three others, including his girlfriend. He was driven from the scene by his friend and his friend's wife. He later shot and killed his friend, but his attempt to kill his friend's wife failed when his gun malfunctioned.",2018
2242,2018-07-30,Savannah,Georgia,0,4,4,Four people were injured when shots were fired during a dispute in a parking lot.,2018
2243,2018-07-30,Chicago,Illinois,0,4,4,Four people were injured in a drive-by shooting.,2018
2244,2018-07-29,Phoenix,Arizona,1,4,5,One person was killed and four were injured in a shooting following a verbal altercation at an inn.,2018
2245,2018-07-29,Lansing,Michigan,0,4,4,Four people were injured when they were shot after a fight broke out.,2018
2246,2018-07-29,York,Pennsylvania,0,4,4,Four people were injured in a shooting.,2018
2247,2018-07-28,New Orleans,Louisiana,3,7,10,Two gunmen killed three people and injured seven others in a shooting at a daiquiri shop.,2018
2248,2018-07-28,Los Angeles,California,2,4,6,Two people were killed and six were injured in a drive-by shooting by a liquor store.,2018
2249,2018-07-27,Chicago,Illinois,0,4,4,Three children and an adult were injured in a shooting.,2018
2250,2018-07-27,Robstown,Texas,5,0,5,"A man killed his father and stepmother, as well as their adopted son and his stepmother's son, before killing himself in a murder–suicide at a nursing home.",2018
2251,2018-07-26,Dallas,Texas,0,6,6,Six people were injured in a drive-by shooting.,2018
2252,2018-07-26,Oakland,California,2,2,4,"A gunman shot at a moving car, killing two occupants and injuring the other two.",2018
2253,2018-07-26,Cleveland,Ohio,1,6,7,One person was killed and six were injured in a shootout involving multiple gunmen at a bar after the filming of a rap music video.,2018
2254,2018-07-25,New Orleans,Louisiana,0,4,4,Four people were injured when a truck pulled up beside a car and one or more of its occupants began shooting. A suspect was arrested.,2018
2255,2018-07-23,Chicago,Illinois,0,5,5,Five people were wounded when someone began firing at them while they stood on a sidewalk.,2018
2256,2018-07-21,Chicago,Illinois,2,5,7,Two people were killed and five injured when they were shot by four gunmen in a park.,2018
2257,2018-07-21,Baltimore,Maryl,0,4,4,Four people were wounded in a shooting.,2018
2258,2018-07-20,Elizabeth,New Jersey,0,4,4,Four people were wounded when three gunmen began shooting at them at a restaurant.,2018
2259,2018-07-20,Sunnyside,Washington,1,4,5,One person was killed and four were injured after a shooter opened fire into a backyard party.,2018
2260,2018-07-18,Oklahoma City,Oklahoma,0,4,4,"Four people were wounded when shots were fired during a large fight in an apartment complex. Four people were arrested on other charges, but the shooter or shooters were not identified.",2018
2261,2018-07-16,Washington,District of Columbia,1,4,5,"Masked men drove up in a car and began shooting into a crowd, killing a ten-year-old girl and injuring three others. Three people were arrested in relation to the shooting.",2018
2262,2018-07-16,Palm Beach Gardens,Florida,2,4,6,Two people were killed and four others were injured when a gunman began shooting at them while they were standing in a yard.,2018
2263,2018-07-16,Philadelphia,Pennsylvania,1,4,5,Two gunmen killed one person and injured four others.,2018
2264,2018-07-15,Denver,Colorado,0,4,4,Four people were wounded during a shooting following a fight at a party.,2018
2265,2018-07-15,Chattanooga,Tennessee,0,5,5,Five people were injured when a shooter fired into a group of people gathered in a parking lot outside a club.,2018
2266,2018-07-14,Fort Washington,Maryl,0,4,4,Four people were injured in a shooting.,2018
2267,2018-07-13,Richmond,Virginia,1,3,4,One person was killed and three people were wounded in a shooting outside a nightclub in Scott's Addition.,2018
2268,2018-07-12,Memphis,Tennessee,0,5,5,Five people were wounded in a shooting near a community center. Police believe the shooting was spurred by an earlier fight over a dice game.,2018
2269,2018-07-11,Houston,Texas,0,4,4,Four people were injured in a drive-by shooting while they were inside their car at restaurant.,2018
2270,2018-07-11,Reddick,Florida,0,4,4,"Gunmen injured four people—two inside a mobile home, and two in separate vehicles outside of the home.",2018
2271,2018-07-09,Prices Corner,Delaware,5,0,5,A man killed his wife and three children in their home before killing himself in a murder–suicide.,2018
2272,2018-07-09,Orlando,Florida,1,4,5,"Following a fight, a man was killed and four other people were injured by gunshots. Two people were arrested.",2018
2273,2018-07-08,Lowndes County,Alabama,0,6,6,"Six people, including a suspect, were wounded during a shooting at a bar.",2018
2274,2018-07-08,Memphis,Tennessee,0,4,4,Four people were injured in a shooting.,2018
2275,2018-07-07,Wetumpka,Alabama,3,2,5,A man killed his wife and one of his children and wounded his other two children before setting the house on fire and killing himself in a murder–suicide.,2018
2276,2018-07-05,New York City,New York,0,4,4,Four people were injured in Brooklyn when they were shot at while standing outside.,2018
2277,2018-07-05,Albany,New York,0,4,4,Four people were injured in a shooting.,2018
2278,2018-07-05,Los Angeles,California,3,3,6,Three people were killed and three others were wounded during a Fourth of July party. Police believe the shooting was gang-related.,2018
2279,2018-07-05,Virginia Beach,Virginia,0,6,6,Six people were injured while walking down the street. A suspect was taken into custody.,2018
2280,2018-07-05,Lima,Ohio,1,5,6,One person was killed and five were injured in a shooting at a Fourth of July party.,2018
2281,2018-07-04,Gary,Indiana,1,3,4,One person was killed and three were wounded.,2018
2282,2018-07-04,Atlanta,Georgia,1,3,4,"After a bar fight spilled into a parking lot, shots were fired, killing one person and wounding three others.",2018
2283,2018-07-03,Washington,District of Columbia,0,4,4,Four people were injured in a shooting.,2018
2284,2018-07-03,St. Louis,Missouri,1,5,6,One person was killed and five others were wounded in a drive-by shooting.,2018
2285,2018-07-02,Buffalo,New York,2,2,4,"A woman and a 17-month-old child were killed in a shooting that injured two others. One person was taken into custody, although police suspect others were involved. Police believe the shooting was gang-related.",2018
2286,2018-07-01,Chicago,Illinois,0,6,6,"Six people were injured when a gunman opened fire on three people on a sidewalk. In addition to the three people on the sidewalk, three children in a car were wounded.",2018
2287,2018-06-30,Ashburn,Georgia,1,6,7,"Several shooters fired into a crowd that was fleeing a nightclub, killing one person and injuring six. Police arrested one suspect, and believe the shooting was gang-related.",2018
2288,2018-06-30,Baltimore,Maryl,0,6,6,Six people were injured at a barbecue when an unknown person walked into the yard and began firing.,2018
2289,2018-06-30,Jersey City,New Jersey,0,5,5,Five people were injured when several people began exchanging gunfire. One suspect was arrested.,2018
2290,2018-06-28,Annapolis,Maryl,5,2,7,Capital Gazette shooting: A gunman entered the offices of The Capital Gazette and killed five employees and wounded two others.,2018
2291,2018-06-27,Oakland,California,1,3,4,One person was killed and three were injured when at least one person began shooting at them outside a mini-mart.,2018
2292,2018-06-27,San Antonio,Texas,0,4,4,"During an argument between neighbors, two people drew weapons and wounded four people. One suspect was arrested.",2018
2293,2018-06-27,Hartford,Connecticut,0,4,4,Four victims were injured in a drive-by shooting outside a bodega.,2018
2294,2018-06-25,Chicago,Illinois,0,6,6,Six people were injured when a gunman began firing upon them as they stood near a park.,2018
2295,2018-06-24,Punta Gorda,Florida,0,4,4,Four people were wounded when an uninvited guest at a birthday party at an event center began shooting.,2018
2296,2018-06-24,Sanford,North Carolina,1,6,7,One person was killed and six were injured during a fight at a birthday party. One of the wounded was arrested.,2018
2297,2018-06-24,Indiantown,Florida,0,4,4,Four people were injured in a shooting at a block party.,2018
2298,2018-06-24,Palm Beach Gardens,Florida,1,3,4,One person was killed and three were injured in a shooting. Six teenage suspects were arrested in relation to the shooting after leading police on a car chase.,2018
2299,2018-06-24,Gary,Indiana,1,3,4,One person was killed and three were wounded in a shooting.,2018
2300,2018-06-24,Sandusky,Ohio,0,5,5,"After several fights inside a bar led the bar owner to close for the night, the fights continued outside before escalating to a shooting in which five people were wounded.",2018
2301,2018-06-23,Wichita,Kansas,0,4,4,Four people were injured in a gang-related shooting.,2018
2302,2018-06-23,Chicago,Illinois,1,4,5,One person was killed and four others were injured after being shot at from a vehicle.,2018
2303,2018-06-23,Covington,Tennessee,0,4,4,Four people were injured in a shooting.,2018
2304,2018-06-22,Homestead,Pennsylvania,1,3,4,One person was killed and three were injured when their car was shot at from another car.,2018
2305,2018-06-21,Chicago,Illinois,0,4,4,Four people were wounded in a shooting.,2018
2306,2018-06-21,Morganza,Louisiana,0,4,4,Four people were wounded in a shooting.,2018
2307,2018-06-21,San Bernardino,California,1,3,4,One person was killed and three were wounded in a fight that progressed to a shooting outside of a liquor store.,2018
2308,2018-06-20,Modesto,California,0,5,5,Five people were injured when someone drew a gun and began shooting during a fight.,2018
2309,2018-06-19,Huntsville,Alabama,0,4,4,A man returned after an argument and wounded four people. He was later taken into custody.,2018
2310,2018-06-18,Chicago,Illinois,2,3,5,Two people were killed and three people were injured in a shooting after a fight at a party.,2018
2311,2018-06-18,Bloomington,Illinois,3,1,4,Three people were killed and a four-year-old child was wounded in a shooting.,2018
2312,2018-06-17,Trenton,New Jersey,1,22,23,Art All Night shooting: Multiple gunmen wounded 17 people at the Art All Night festival. Five others were wounded when they were trampled by people around them. One of the suspected gunmen was shot and killed by police. Police suspect the shooting was gang-related.,2018
2313,2018-06-17,Macon,Georgia,1,3,4,A teenager was killed and three other people were injured in a drive-by shooting during a cookout. A 15-year-old was later charged with the killing.,2018
2314,2018-06-17,Chicago,Illinois,0,4,4,A gunman walked up to and wounded four people standing on the street.,2018
2315,2018-06-17,Charlotte,North Carolina,0,4,4,Four people were injured in a shooting at a gas station.,2018
2316,2018-06-14,Tracy,California,1,4,5,A fight turned into a shooting that resulted in a 15-year-old being killed and four other people being injured.,2018
2317,2018-06-14,Westminster,Colorado,1,3,4,"A 13-year-old boy was killed, and his mother, 8-year-old brother, and a bystander were wounded in a road rage incident after the shooter followed them to the parking lot of a dentist's office. The shooter was arrested.",2018
2318,2018-06-14,Buffalo,New York,1,4,5,One person was killed and four were wounded in a drive-by shooting.,2018
2319,2018-06-14,Philadelphia,Pennsylvania,0,4,4,Four people were injured in a shooting.,2018
2320,2018-06-14,Union City,California,0,5,5,Five people were injured in a shooting that took place in a cemetery.,2018
2321,2018-06-12,New York City,New York,0,4,4,Four people were injured in a shooting in the Bronx.,2018
2322,2018-06-11,Montgomery,Alabama,0,4,4,Four people were injured in a shooting after a verbal altercation. Three suspects were arrested.,2018
2323,2018-06-11,Orlando,Florida,5,1,6,"After barricading himself and his four children in a home for nearly 24 hours, a man shot and wounded a police officer before killing the four children and himself.",2018
2324,2018-06-10,Valley Village,California,0,6,6,Six people were injured by gunfire at a birthday party.,2018
2325,2018-06-10,Bradenton,Florida,1,5,6,One person was killed and five others were injured after a fight in a bar moved outside and a member of one of the groups began shooting.,2018
2326,2018-06-10,Chicago,Illinois,1,5,6,One person was killed and five others were injured in a drive-by shooting.,2018
2327,2018-06-10,Bloomington,Illinois,2,2,4,Two people were killed and two others were wounded after a shooting at a birthday party. The suspect was later taken into custody.,2018
2328,2018-06-10,Aurora,Illinois,0,7,7,"Seven people were injured after gunfire broke out at a party. Several men arrived at the home and began to shoot, and an attendee at the party shot back. The police believe the incident was gang-related.",2018
2329,2018-06-10,Indianapolis,Indiana,1,4,5,A 14-year-old boy was killed and four other people were wounded at a party. A 14-year-old boy was arrested in connection to the shooting.,2018
2330,2018-06-09,Philadelphia,Pennsylvania,1,4,5,Four or five gunmen killed one person and injured four others.,2018
2331,2018-06-09,Kannapolis,North Carolina,0,4,4,Four people were wounded after a gunman began shooting outside a high school graduation party.,2018
2332,2018-06-09,Boston,Massachusetts,0,4,4,Four people were injured in a shooting at a house party.,2018
2333,2018-06-05,Jacksonville,Florida,3,1,4,Three men were killed and a fourth was injured after a car pulled up alongside theirs and the occupant began shooting.,2018
2334,2018-06-04,Scottsdale,Arizona,7,0,7,"2018 Scottsdale shootings: Over the course of several days , a man killed a forensic psychologist, two paralegals, a counselor, and a couple from whom he took a handgun. The suspect killed himself when police began closing in on him.",2018
2335,2018-06-03,Chicago,Illinois,1,3,4,One person was killed and three others were wounded by two gunmen in a drive-by shooting.,2018
2336,2018-06-03,Dallas,Texas,0,5,5,"After an argument at a football game, a man drove a moped into the middle of the field and began to fire a gun. Multiple people then began firing at the shooter. Five people were injured in the exchange of gunshots.",2018
2337,2018-06-02,Buffalo,New York,0,5,5,Five people were injured in a shooting at an outdoor gathering.,2018
2338,2018-06-02,Omaha,Nebraska,1,6,7,One person was killed and six others were injured in a shooting. A suspect was taken into custody.,2018
2339,2018-05-31,Timmonsville,South Carolina,3,2,5,"A man killed a woman and two of her daughters, and injured her husband and her third daughter, when he shot them at their home. He has been arrested.",2018
2340,2018-05-27,Shreveport,Louisiana,0,4,4,Four people were injured in a shooting on the bank of the Red River.,2018
2341,2018-05-27,Aurora,Colorado,1,3,4,A fight in a nightclub spilled into the parking lot and resulted in a shooting that killed one person and injured three others.,2018
2342,2018-05-25,Cincinnati,Ohio,0,4,4,A shooting broke out after a man tried to rob a group of people playing dice. Four people were injured by gunshots. Two men were arrested.,2018
2343,2018-05-20,Hazlehurst,Mississippi,1,7,8,"Two suspects fired shots into a nightclub, killing one person and wounding seven others.",2018
2344,2018-05-20,Anderson,Indiana,0,4,4,Four people were wounded in a shooting at a block party.,2018
2345,2018-05-18,Santa Fe,Texas,10,14,24,"Santa Fe High School shooting: A student at Santa Fe High School shot and killed ten people and wounded fourteen others. Explosive devices were also found, but they were not detonated. The suspect was taken into custody by police.",2018
2346,2018-05-16,Ponder,Texas,5,1,6,A man wounded his ex-wife and killed their three children and his ex-wife's boyfriend before killing himself in a murder–suicide.,2018
2347,2018-05-14,Baltimore,Maryl,0,4,4,Four men were wounded in a shooting near a playground.,2018
2348,2018-05-13,Stockton,California,3,2,5,"A shooter fired into a home, killing a five-year-old girl and her parents, and wounding two other family members.",2018
2349,2018-05-13,Byhalia,Mississippi,0,4,4,"A man opened fire at a block party, possibly after a fight over a dice game, wounding four people. The suspect was arrested.",2018
2350,2018-05-13,Los Angeles,California,2,2,4,A man killed one teenage boy and wounded three others. One of the wounded boys died in the hospital several days later.,2018
2351,2018-05-12,Omaha,Nebraska,0,7,7,Seven people were wounded in a shooting.,2018
2352,2018-05-12,Paulsboro,New Jersey,0,4,4,Four people were injured by gunfire in a shooting following a fight at a birthday party.,2018
2353,2018-05-11,Talihina,Oklahoma,1,4,5,"Four police officers were injured in a shootout while trying to execute a search warrant, either by gunfire or from shrapnel from explosives in the home. The suspect was killed.",2018
2354,2018-05-11,St. Louis,Missouri,0,4,4,Two children and two adults were injured when shooters fired at them from two cars.,2018
2355,2018-05-09,Omaha,Nebraska,0,4,4,Four people were injured in a suspected drive-by shooting outside an apartment complex.,2018
2356,2018-05-09,St. Louis,Missouri,0,4,4,Four people were wounded in a shooting.,2018
2357,2018-05-07,San Diego,California,0,5,5,Two men approached a group of people and wounded four people. A fifth victim was shot and wounded several blocks away. Police believe the first attack was gang-related.,2018
2358,2018-05-06,Stillwater,Oklahoma,0,4,4,"After a fight and theft from the bar and a tip jar, private security shut down a party. As the guests left, several weapons were fired and four people were injured.",2018
2359,2018-05-06,Memphis,Tennessee,2,4,6,Two people were killed and four were injured after they were shot while traveling in a car by a gunman in another car.,2018
2360,2018-05-05,Columbus,Georgia,0,5,5,Five people were injured in a shooting. A suspect was arrested.,2018
2361,2018-05-04,Henderson,North Carolina,0,4,4,Four people were injured in a shooting.,2018
2362,2018-05-04,Chicago Heights,Illinois,0,4,4,A shooting at a house party wounded four people.,2018
2363,2018-05-02,Chicago,Illinois,1,4,5,"A man shot at a group of people from a car, killing one and wounding four. He and the driver of the car were later arrested.",2018
2364,2018-05-02,New York City,New York,1,4,5,One person was killed and four were wounded following a shooting outside of a Brooklyn apartment complex.,2018
2365,2018-05-02,Minneapolis,Minnesota,0,6,6,Six people were wounded after guns were fired following an argument at a housing complex. Three people were arrested.,2018
2366,2018-05-01,New Orleans,Louisiana,0,5,5,Five people were injured in a shooting.,2018
2367,2018-04-30,Pompano Beach,Florida,0,4,4,A man pulled out a gun after being punched during an after-party at a club and wounded four people.,2018
2368,2018-04-30,Washington,District of Columbia,0,4,4,Four people were injured in a drive-by shooting.,2018
2369,2018-04-29,Wartburg,Tennessee,0,4,4,A man shot and wounded two people at an apartment complex. Two more people were wounded by gunfire while trying to disarm the shooter. The shooter was arrested.,2018
2370,2018-04-29,Bryn Mawr-Skyway,Washington,2,2,4,Two people were killed and two others were injured in a shooting in a parking lot outside a motorcycle club.,2018
2371,2018-04-29,Monroe,North Carolina,1,3,4,A man killed one person and wounded three others in a shooting. He was later arrested by police.,2018
2372,2018-04-29,West Palm Beach,Florida,1,3,4,A man killed one person and injured three others in a shooting at a nightclub. He was later arrested by police.,2018
2373,2018-04-28,Maxton,North Carolina,0,5,5,Five were injured in a shooting following an argument at a party.,2018
2374,2018-04-25,Pine Bluff,Arkansas,0,4,4,Four people were injured after men stepped out of a truck and began shooting at them.,2018
2375,2018-04-25,St. Louis,Missouri,3,1,4,Three people were killed and one was wounded after being shot in a home. A suspect was later taken into custody by police.,2018
2376,2018-04-24,Flint,Michigan,0,4,4,Four people were injured in a shooting.,2018
2377,2018-04-22,Nashville,Tennessee,4,2,6,"Nashville Waffle House shooting: A gunman entered a Waffle House, where he killed four people and injured two others. He was later taken into custody.",2018
2378,2018-04-22,New Orleans,Louisiana,1,5,6,"After a domestic issue, a man went on a shooting spree that resulted in one death and five people being injured by gunfire. The man was arrested.",2018
2379,2018-04-21,Philadelphia,Pennsylvania,2,2,4,A man killed two people and wounded two others after being kicked out of a party.,2018
2380,2018-04-20,San Francisco,California,1,5,6,"A gunman shot six men standing near each, killing one and injuring five.",2018
2381,2018-04-18,Asheville,North Carolina,4,3,7,"A man killed a mother and two of her children, wounded her other three children, and then killed himself.",2018
2382,2018-04-15,Shreveport,Louisiana,0,6,6,Six people in a tattoo parlor were injured when they were shot at by a person in a pickup truck outside the business.,2018
2383,2018-04-09,Vallejo,California,0,4,4,Four people were injured in a shooting outside an apartment complex.,2018
2384,2018-04-08,Miami,Florida,2,2,4,Two people were killed and two were wounded in a shooting in the Liberty City neighborhood of Miami.,2018
2385,2018-04-08,Hickory,North Carolina,1,3,4,"Several people fired hundreds of rounds outside of a bar, killing one person and injuring three others. Three men were arrested.",2018
2386,2018-04-06,Jacksonville,Florida,0,4,4,Four people were wounded in a shooting.,2018
2387,2018-04-06,Virginia Beach,Virginia,1,3,4,One person was killed and three others were injured in a shooting.,2018
2388,2018-04-04,New Orleans,Louisiana,2,2,4,Two people were killed and two others were injured in a shooting.,2018
2389,2018-04-03,San Bruno,California,1,4,5,"YouTube headquarters shooting: A woman approached an outdoor patio at YouTube Headquarters and wounded three people before committing suicide, a fourth person was injured in the evacuation.",2018
2390,2018-04-02,Houston,Texas,1,3,4,One person was killed and three others were wounded in a drive-by shooting outside of a home.,2018
2391,2018-04-01,Mobile,Alabama,1,4,5,A fifteen-year-old was killed and four other people were wounded in a shooting at a spring break party.,2018
2392,2018-04-01,Saginaw,Michigan,0,5,5,Five people were injured in a shooting at a house party.,2018
2393,2018-03-31,Asbury Park,New Jersey,0,5,5,Five people were wounded in a drive-by shooting.,2018
2394,2018-03-29,Camden,New Jersey,0,4,4,Four people were wounded in a shooting inside a business.,2018
2395,2018-03-29,Plano,Texas,1,3,4,One person was killed and three others were injured in a shooting at an apartment complex. One person was arrested.,2018
2396,2018-03-24,West Valley City,Utah,0,4,4,Four people were injured in a drive-by shooting directed at a traveling rap group. The shooting may have been gang-related.,2018
2397,2018-03-21,San Francisco,California,1,5,6,"A police officer, the suspect, and four others were all wounded by gunfire. One of the wounded victims later died of his injuries.",2018
2398,2018-03-17,Louisville,Kentucky,0,7,7,Seven people were injured in a shooting in a nightclub.,2018
2399,2018-03-17,Harvey,Illinois,0,4,4,"Four men were wounded in a shooting in a strip club, which seemed to stem from an earlier incident at a different nightclub.",2018
2400,2018-03-13,Macclenny,Florida,0,4,4,Four people were injured in a drive-by shooting. Two people were later arrested.,2018
2401,2018-03-12,Modesto,California,0,4,4,Four people were injured when shots were fired through the garage door of the garage they were in.,2018
2402,2018-03-11,Saginaw,Michigan,0,5,5,Five people were injured in a shooting following an argument at a party.,2018
2403,2018-03-11,Champaign,Illinois,1,3,4,Three people were wounded and one other was fatally injured in a nightclub shooting following a verbal argument.,2018
2404,2018-03-11,South Bend,Indiana,0,6,6,Six people were wounded when a man began shooting at a house party. He was arrested.,2018
2405,2018-03-09,Yountville,California,5,0,5,Yountville Shooting: A man entered the Veterans Home of California and held three staff members hostage. He killed the three staff members  before killing himself in a murder–suicide.,2018
2406,2018-03-09,Wadesboro,North Carolina,3,1,4,A man killed three people and injured one other in a shooting at a restaurant and bar. He was arrested two days later.,2018
2407,2018-03-07,Hurtsboro,Alabama,2,2,4,A man entered a restaurant and killed the restaurant's owner and wounded three others. He was later taken into custody by police.,2018
2408,2018-03-04,Rockford,Illinois,1,4,5,One man was killed and four other people were injured in a shooting at a party.,2018
2409,2018-03-03,Miami,Florida,0,4,4,Four people were injured in a shooting.,2018
2410,2018-03-03,New York City,New York,1,3,4,One person was killed and three were injured in a shooting or series of shootings in a close vicinity in Brooklyn.,2018
2411,2018-02-27,Bridgeport,Connecticut,0,4,4,Four people were wounded after being shot by at least three shooters.,2018
2412,2018-02-26,Detroit,Michigan,5,0,5,"A man shot and killed the mother of his child and another woman who was sitting with her in a car at a gas station. He then killed another man at the gas station before returning home and killing his cousin. After being urged by his mother to turn himself in to police, the suspect killed himself.",2018
2413,2018-02-23,Palm Beach Gardens,Florida,1,3,4,One person was killed and three were injured after a drug deal.,2018
2414,2018-02-18,San Antonio,Texas,0,5,5,Five people were injured in a shooting outside a Texas Roadhouse.,2018
2415,2018-02-17,Memphis,Tennessee,0,5,5,Five people were wounded in a shooting outside a nightclub.,2018
2416,2018-02-17,Kansas City,Kansas,1,7,8,One person was killed and seven others were injured at a party in what police suspect to be a gang-related shooting.,2018
2417,2018-02-16,Oklahoma City,Oklahoma,1,3,4,One person was killed and three were injured inside a home. The man who died had been receiving threats after falling out with a gang. Two people were arrested.,2018
2418,2018-02-14,Parkland,Florida,17,17,34,"Stoneman Douglas High School shooting: A former student of Marjory Stoneman Douglas High School entered the school, killed seventeen people, and wounded seventeen others. He was taken into custody by police.",2018
2419,2018-02-13,New Orleans,Louisiana,3,5,8,A series of shootings left three people dead and five others wounded during the Mardi Gras celebration in New Orleans.,2018
2420,2018-02-11,Detroit,Michigan,4,3,7,Three women were killed and three police officers were wounded before a gunman killed himself in a murder–suicide in a home.,2018
2421,2018-02-10,Paintsville,Kentucky,5,0,5,A gunman killed two people in a home and two other people in an apartment building before killing himself in a murder–suicide.,2018
2422,2018-02-07,Lake Worth,Florida,3,3,6,A man killed two people and injured three others in a series of shootings before being shot and killed by a police officer.,2018
2423,2018-02-05,Colorado Springs,Colorado,2,4,6,A sheriff's deputy was killed and three detectives and a passerby were wounded in a shooting. The suspect was killed by police.,2018
2424,2018-02-03,Cleveland,Ohio,1,5,6,One person was killed and five others were injured in a shooting at a sports bar.,2018
2425,2018-01-31,St. Louis,Missouri,0,4,4,Three people in a car and a man standing at a bus stop were injured when they were shot at by someone in another vehicle.,2018
2426,2018-01-28,Melcroft,Pennsylvania,5,0,5,"A man shot his ex-girlfriend and three other people at a car wash. The suspect also sustained a gunshot injury, suspected to be self-inflicted, and later died of his injuries.",2018
2427,2018-01-28,Reading,Pennsylvania,4,0,4,Four men were killed in a shooting in an apartment.,2018
2428,2018-01-28,Indianapolis,Indiana,2,3,5,Two were killed and three people were injured in a shooting at a bar.,2018
2429,2018-01-27,Los Angeles,California,0,5,5,Five people were injured in a gang-related drive-by shooting.,2018
2430,2018-01-27,Bowling Green,Kentucky,0,4,4,Four people were wounded in a fight in and outside a club.,2018
2431,2018-01-25,Washington,District of Columbia,0,4,4,Four people were injured in a shooting.,2018
2432,2018-01-23,Philadelphia,Pennsylvania,0,4,4,Four people were injured in a drive-by shooting.,2018
2433,2018-01-23,Benton,Kentucky,2,16,18,Marshall County High School Shooting: A fifteen-year-old student killed two other students and injured sixteen others before discarding his weapon and attempting to hide among other students. He was apprehended by police.,2018
2434,2018-01-21,Orlando,Florida,0,4,4,Four children were injured in a shooting. Two teenage suspects were arrested by police.,2018
2435,2018-01-21,Chicago,Illinois,0,4,4,Four people were injured after being shot near the entrance to a party.,2018
2436,2018-01-17,Washington,District of Columbia,1,3,4,A man killed one person and injured three others after determining them to be acquaintances of a person who stole his favorite pistol. The man was later taken into custody.,2018
2437,2018-01-15,Alachua,Florida,0,5,5,Five people were injured in a gang-related drive-by shooting believed to be related to a murder that had happened the previous day. Two suspects were arrested.,2018
2438,2018-01-14,Eutaw,Alabama,1,4,5,One person was killed and four were injured in a shooting following a fight at a biker club party.,2018
2439,2018-01-14,Madison,Alabama,0,4,4,Four people were injured in a shooting at a hotel. A suspect was arrested.,2018
2440,2018-01-12,Nashville,Tennessee,3,2,5,"A man wounded his stepmother and killed her two daughters before highjacking a car, killing the driver and wounding the passenger. A suspect was arrested after abandoning the car.",2018
2441,2018-01-11,St. Robert,Missouri,2,2,4,"Four people were discovered in a vehicle, two deceased and two wounded, after police responded to calls of an abandoned car.",2018
2442,2018-01-07,Union Springs,Alabama,1,5,6,A shooting on US Highway 29 led to the shooting of another person at a local hospital. One person was killed and five others were wounded. Three suspects were arrested.,2018
2443,2018-01-07,Plantation,Florida,0,4,4,Four people were wounded while leaving a private party.,2018
2444,2018-01-05,Hattiesburg,Mississippi,0,6,6,Six people were wounded in a drive-by shooting behind a bar.,2018
2445,2018-01-04,Brinkley,Arkansas,1,3,4,A 33-year-old was killed and three others wounded in a common area of an apartment complex.,2018
2446,2018-01-01,Huntsville,Alabama,1,3,4,A 21-year-old was killed and three others were wounded shortly after midnight at a New Year's Eve party.,2018
2447,2017-12-31,Highlands Ranch,Colorado,2,6,8,"Copper Canyon Apartment Homes shooting: After being called to a home for a report of a disturbance, five police officers were shot in an ""ambush-style"" attack. One officer was killed and the other four were wounded. Two other people were also wounded in a neighboring apartment. Officers later re-entered the apartment with a SWAT team and killed the suspect; another officer was injured in this exchange.",2017
2448,2017-12-07,Aztec,New Mexico,3,0,3,Aztec High School shooting: A man walked into Aztec High School disguised as a student and killed two before killing himself.,2017
2449,2017-11-13,Tehama County,California,6,12,18,"Rancho Tehama Reserve shootings: A man killed his wife and hid her body under the floorboards of their home before killing two neighbors, firing at random at people, and then ramming his truck through the gates of an elementary school and firing at those inside. He then drove away and targeted other random victims before being rammed by police and shooting himself. He killed five people and injured twelve others  before committing suicide.",2017
2450,2017-11-05,Sutherland Springs,Texas,27,22,49,"Sutherland Springs church shooting: A gunman approached the First Baptist Church in Sutherland Springs and killed two people outside before entering and shooting at the congregation, killing 26 people  and injuring 22. He was confronted by a local man with a gun, and they exchanged gunfire before entering a vehicle. The man flagged down another person and they began a high-speed chase of the gunman, which ended when the gunman went off the road and was found dead from a self-inflicted gunshot wound.",2017
2451,2017-10-01,Paradise,Nevada,61,411,472,"2017 Las Vegas shooting: A man on the 32nd floor of a hotel opened fire on a country music festival happening outside, killing 60 people and injuring 867 others, with 411 of them suffering from gunshot wounds. The man then shot himself.",2017
2452,2017-09-24,Antioch,Tennessee,1,8,9,"Burnette Chapel shooting: A man killed a woman outside the Burnette Chapel Church of Christ before entering the chapel and wounding seven others. During a struggle with an usher, the man shot himself in the chest. The usher ran to his car to get his own pistol and held the man at gunpoint until police arrived to arrest him.",2017
2453,2017-09-10,Plano,Texas,9,1,10,"2017 Plano shooting: A man entered his ex-wife's home while she was hosting a football-watching party and killed her and seven others, and wounded one other. He was killed by police.",2017
2454,2017-08-28,Clovis,New Mexico,2,4,6,Clovis library shooting: A sixteen-year-old killed two people and wounded four others at a public library before surrendering to police.,2017
2455,2017-07-01,Little Rock,Arkansas,0,28,28,Little Rock nightclub shooting: Twenty-eight people were injured  when shooting broke out in a nightclub where rapper Finese 2Tymes was performing.,2017
2456,2017-06-30,New York City,New York,2,6,8,Bronx-Lebanon Hospital attack: A former hospital employee killed a doctor and wounded six others before he committed suicide.,2017
2457,2017-06-14,San Francisco,California,4,5,9,"San Francisco UPS shooting: A gunman entered his workplace and singled out coworkers, killing three and wounding five, before committing suicide.",2017
2458,2017-06-14,Alexandria,Virginia,1,6,7,"Congressional baseball shooting: A gunman shot and wounded four people, including Republican Congressman and House Majority Whip Steve Scalise, while they were practicing for the Congressional Baseball Game. Two others were also injured in other ways. The gunman was killed after being engaged by Capitol police officers assigned to protect Scalise and by police officers responding to the scene.",2017
2459,2017-06-08,Eaton Township,Pennsylvania,4,0,4,Eaton Township Weis Markets shooting: An employee of a Weis Markets supermarket who was working a night shift barricaded the exits and killed three coworkers before killing himself.,2017
2460,2017-06-06,Sandy,Utah,3,2,5,"Sandy, Utah attack: A man rammed a vehicle containing his ex-girlfriend, three children and one other adult, opened fire, killing two and wounding two, then committed suicide.",2017
2461,2017-06-05,Orlando,Florida,6,0,6,Orlando factory shooting: A former employee entered the factory through a rear exit and killed five employees and then himself.,2017
2462,2017-05-27,Lincoln County,Mississippi,8,1,9,"2017 Mississippi shootings: A man killed eight people, including several family members and a sheriff's deputy, at three separate houses. He was injured by police and then arrested. The shooter later said he had intended to commit suicide by cop.",2017
2463,2017-05-12,Kirkersville,Ohio,4,0,4,"Kirkersville shooting: After taking two people hostage, a man shot and killed a police officer and two nurses at a nursing home before he killed himself.",2017
2464,2017-04-10,San Bernardino,California,3,1,4,"North Park Elementary School shooting: A man entered an elementary school, telling school administrators he needed to drop something off for his wife. He entered the classroom where she was teaching and killed her, also killing a student and wounding another who were standing nearby. He then killed himself.",2017
2465,2017-03-26,Cincinnati,Ohio,2,16,18,Cincinnati nightclub shooting: Two men were killed and sixteen people were wounded after a fight escalated into a shooting at a crowded nightclub. One person was arrested.,2017
2466,2017-03-22,Schofield and Rothschild,Wisconsin,5,0,5,"2017 Schofield/Rothschild shootings: A man demanded his wife sign divorce papers and after a confrontation, returned to her place of work and shot and killed four people before being killed by the police.",2017
2467,2017-01-06,Broward County,Florida,5,6,11,"Fort Lauderdale airport shooting: A man killed five people and injured six in a shooting at Fort Lauderdale–Hollywood International Airport before running out of ammunition and lying on the ground to surrender to police. Thirty to forty other people were also hurt, with injuries not directly caused by gunfire.",2017
2468,2016-09-28,Townville,South Carolina,2,3,5,Townville Elementary School shooting: A fourteen-year-old shot and killed his father before driving to the local elementary school and injuring three students and a teacher. One student later died of his injuries. The shooter was later arrested.,2016
2469,2016-09-23,Burlington,Washington,5,0,5,Cascade Mall shooting: A man killed five people at the Cascade Mall. He was arrested a day later. The shooter later killed himself while in jail.,2016
2470,2016-08-20,Citronelle,Alabama,6,0,6,2016 Citronelle homicides: A man killed six people  while they were sleeping in a home. He was arrested by police.,2016
2471,2016-07-30,Mukilteo,Washington,3,1,4,2016 Mukilteo shooting: A student at the University of Washington killed three people and injured one other in a shooting at a party. One of the people he killed was his ex-girlfriend. The shooter was arrested and sentenced to life in prison.,2016
2472,2016-07-17,Baton Rouge,Louisiana,5,2,7,"2016 shooting of Baton Rouge police officers: A gunman killed four law enforcement officers, one of whom died in 2022, and injured three others. The gunman was killed by a member of the SWAT team that responded to the shooting. The shooting is believed to have been related to the unrest in Baton Rouge following the shooting of Alton Sterling, and the gunman was involved with black separatist and sovereign citizen organizations.",2016
2473,2016-07-11,St. Joseph,Michigan,3,2,5,St. Joseph courthouse shooting: A handcuffed inmate killed two bailiffs and injured a deputy and another woman after taking a deputy's gun in a courthouse. The inmate was killed by two other bailiffs.,2016
2474,2016-07-07,Dallas,Texas,6,11,17,2016 shooting of Dallas police officers: A shooter killed five police officers and wounded nine other officers and two civilians at a protest over the police shootings of Alton Sterling and Philando Castile. The shooter was killed by a bomb delivered by a remote control vehicle. He is believed to have been motivated by retribution for black men killed by police.,2016
2475,2016-06-12,Orlando,Florida,50,58,108,"Orlando nightclub shooting: A gunman killed 49 people and wounded 53 others in a shooting at Pulse, a gay nightclub. The gunman was killed in a shootout with the police.",2016
2476,2016-03-09,Wilkinsburg,Pennsylvania,6,3,9,"2016 Wilkinsburg mass shooting: Six people  were killed and three were injured by two gunmen in an attack during a backyard party. One person with a handgun drove the partygoers toward a backyard porch, where the second shot at them with an assault-style rifle.",2016
2477,2016-02-25,Hesston and Newton,Kansas,4,14,18,Hesston shooting: A man killed three people and injured fourteen others in an attack at his workplace. He had been served with a temporary order of protection shortly before he began shooting. He was killed by police who responded to the scene.,2016
2478,2016-02-20,Kalamazoo,Michigan,6,2,8,2016 Kalamazoo shootings: An Uber driver is suspected to have killed six people and wounded two others in a series of shootings targeting random people.,2016
2479,2015-12-02,San Bernardino,California,16,22,38,"2015 San Bernardino attack: A married couple opened fire on the husband's colleagues at a work training event. They killed fourteen people and injured twenty-two before being killed in a shootout with police. Pipe bombs set at their residence failed to detonate. The two perpetrators are believed to have been radicalized, though not believed to have been directly connected to a specific foreign terrorist organization.",2015
2480,2015-11-27,Colorado Springs,Colorado,3,9,12,Colorado Springs Planned Parenthood shooting: A man killed two civilians and a police officer and wounded nine others inside a Planned Parenthood clinic before surrendering to police. The shootings are suspected to have been motivated by the suspect's anti-abortion views.,2015
2481,2015-11-23,Minneapolis,Minnesota,0,5,5,"Shooting of protesters at a Black Lives Matter protest: During a Black Lives Matter protest related to the shooting of Jamar Clark, a man opened fire and injured five protestors. The perpetrator was later arrested.",2015
2482,2015-10-31,Colorado Springs,Colorado,4,0,4,"October 2015 Colorado Springs shooting. Noah Harpham killed three. Harpham was open carrying with his rifle for some time, before randomly opening fire on random people on the street ",2015
2483,2015-10-09,Flagstaff,Arizona,1,3,4,"Northern Arizona University shooting: A freshman at Northern Arizona University shot four students, killing one.",2015
2484,2015-10-01,Roseburg,Oregon,10,8,18,"Umpqua Community College shooting: A student at Umpqua Community College killed nine people and injured eight others on the college campus. After being wounded by police officers, he killed himself.",2015
2485,2015-08-26,Moneta,Virginia,3,1,4,"Murders of Alison Parker and Adam Ward: An enraged former employee for WDBJ  carried out a preplanned shooting targeting 3 reporters, conducting a live T.V. interview near Smith Mountain Lake. Alison Parker was fatally shot, and the cameraman Adam Ward was also killed. Vicki Gardner was also shot, but survived. He fled the scene in his car then took off on foot while a massive manhunt was underway. Before police could approach Williams, he committed suicide by shooting himself. He stated that the motive was the Charleston church shooting and possible discrimination at his workplace.",2015
2486,2015-08-08,Harris County,Texas,8,0,8,"2015 Harris County shooting: A man broke into his ex-girlfriend's home and held her hostage along with her husband and six children, one of whom was his son. Over the course of nine hours, he killed everyone in the home. After a shootout with police, he surrendered and was taken into custody.",2015
2487,2015-07-23,Lafayette,Louisiana,3,9,12,"2015 Lafayette shooting: A gunman killed two people and injured nine in a shooting at a movie theater. After trying to blend into the crowd leaving the theater, the gunman heard sirens, returned to the theater, and killed himself.",2015
2488,2015-07-16,Chattanooga,Tennessee,6,2,8,"2015 Chattanooga shootings: A man committed a drive-by shooting at a military recruitment center in a strip mall, wounding one Marine. With police in pursuit, he drove to a U.S. Navy Reserve center and rammed his vehicle through a gate. He fatally wounded a Navy sailor, killed four Marines, and wounded a police officer before being killed by a naval commander. The FBI later determined the gunman had been motivated by propaganda published by terrorist organizations.",2015
2489,2015-06-17,Charleston,South Carolina,9,1,10,"Charleston church shooting: A white supremacist killed nine black people during a prayer service at the Emanuel African Methodist Episcopal Church, wounding one other. He was taken into custody by police, and later said that he committed the shootings in an attempt to start a ""race war"".",2015
2490,2015-05-17,Waco,Texas,9,18,27,"2015 Waco shootout: Gunfire broke out at a restaurant where members of several motorcycle clubs had gathered to discuss political rights for motorcyclists. Members of the clubs and police were both involved in the gunfire. Nine people were killed and eighteen were injured in the shootout, all members of the motorcycle clubs. The shooting may have resulted from a territorial dispute between two of the motorcycle clubs.",2015
2491,2015-02-26,Tyrone,Missouri,8,1,9,2015 Tyrone shooting: A man killed seven people and wounded one after going door-to-door and shooting people in four separate homes. Four of the people he killed were family members. The man then killed himself. The shooting was possibly motivated by the man finding his mother dead from natural causes.,2015
2492,2014-12-15,Montgomery County,Pennsylvania,6,1,7,"2014 Montgomery County shootings: Six people were found dead and one wounded in three locations across Montgomery County. The shooter was found dead the next day after committing suicide by overdose. One of the victims was the shooter's ex-wife, the others were her relatives.",2014
2493,2014-12-12,Portland,Oregon,0,4,4,Rosemary Anderson High School shooting: A perpetrator shot and injured three students and an adult outside of the school.,2014
2494,2014-10-24,Marysville,Washington,5,1,6,Marysville Pilchuck High School shooting: A fifteen-year-old killed four people and injured one other in the cafeteria of Marysville Pilchuck High School before killing himself.,2014
2495,2014-07-09,Spring,Texas,6,1,7,2014 Harris County shooting: A man is suspected of killing six of his family members and wounding a seventh. He was arrested after a brief chase and a standoff that lasted several hours.,2014
2496,2014-05-23,Isla Vista,California,7,13,20,"2014 Isla Vista killings: Several hours after stabbing and killing his three roommates, a man drove to a sorority house near the University of California, Santa Barbara and knocked on the door. After receiving no answer, he began shooting at people nearby, killing two members of another sorority and injuring a third. He then returned to his car and continued to shoot at random people from within his vehicle before killing himself with a gunshot. The attack is believed to have been motivated by the killer's hatred of women and frustration with his dating and family life.",2014
2497,2014-04-02,Fort Hood,Texas,4,14,18,"2014 Fort Hood shooting: After being denied leave from the Fort Hood military base where he was stationed, a man killed three people and injured fourteen before killing himself.",2014
2498,2013-11-01,Los Angeles,California,1,4,5,"2013 Los Angeles International Airport shooting: A man entered the Los Angeles International Airport, killed a TSA agent, and wounded three other people. He was injured when shot several times by police.",2013
2500,2013-08-05,Saylorsburg,Pennsylvania,3,4,7,"Ross Township Municipal Building shooting: A man entered a meeting of township supervisors and killed three people, injuring three others. The gunman was also injured when his gun went off and hit his own leg as two men wrestled him to the ground and took away his weapon. The shooting was suspected to be motivated by a longstanding feud in which the gunman's property rights had been taken away. He was sentenced to life in prison.",2013
2501,2013-07-26,Hialeah,Florida,7,0,7,2013 Hialeah shooting: A man lit his apartment on fire and killed six other people in his apartment building before being killed by a SWAT team.,2013
2502,2013-06-07,Santa Monica,California,6,5,11,"2013 Santa Monica shooting: A man killed two people in a residence before lighting it on fire. He continued to shoot at people while moving towards Santa Monica College, then attempted to carjack a passing vehicle. After firing rounds at a passing bus, he ran into the college library and continued shooting. He killed five people and injured five others before being killed by police.",2013
2504,2013-01-19,South Valley,New Mexico,5,0,5,2013 South Valley homicides: A fifteen-year-old murdered his parents and three siblings in their home. He was arrested by police.,2013
2505,2012-12-24,Webster,New York,3,3,7,"2012 Webster shooting: A man set fire to his home and the family car before opening fire on responding firefighters, two were killed and three wounded before he committed suicide, a fourth body was found in the house.",2012
2506,2012-12-14,Newtown,Connecticut,28,2,30,"Sandy Hook Elementary School shooting: A 20-year old killed his mother before shooting and killing twenty children and six adults at Sandy Hook Elementary School in Newtown, Connecticut. He then committed suicide.",2012
2507,2012-12-11,Clackamas,Oregon,3,1,4,"Clackamas Town Center shooting: A 22-year-old opened fire at the town center wearing a hockey mask, and killed two people and injured a third before fumbling with his weapon and being unable to reload. He committed suicide in a stairwell of the location.",2012
2508,2012-10-21,Brookfield,Wisconsin,4,4,8,"Azana Spa shooting: The perpetrator drove to his ex-wife's work place and waited until she was there to confront her and shot and killed her and two other women, and injured four others before committing suicide.",2012
2509,2012-09-27,Minneapolis,Minnesota,7,2,9,"Accent Signage Systems shooting: A former employee entered a local sign-making business, and killed five and wounded four; two of the four later died of their wounds, the perpetrator committed suicide.",2012
2510,2012-08-24,New York City,New York,2,9,11,Empire State Building shooting: A man shot and killed a former co-worker before engaging in a shoot-out with the New York police in which nine bystanders were wounded and the perpetrator was killed.,2012
2511,2012-08-13,College Station,Texas,3,4,7,"2012 College Station shooting: The perpetrator fatally shot an officer attempting to serve him a notice to appear in court, he then injured a neighbor and engaged in a shootout with responding officers until he was killed by the officers.",2012
2512,2012-08-05,Oak Creek,Wisconsin,7,4,11,"Wisconsin Sikh temple shooting: The perpetrator, a member of the Hammerskins and various white power and neo-Nazi bands, fatally shot six people at a Sikh temple before being killed by responding police officers.",2012
2513,2012-07-20,Aurora,Colorado,12,70,82,"Aurora, Colorado, movie theater shooting: James Eagan Holmes, stormed a late-night premiere of The Dark Knight Rises and shot and killed twelve people and wounded seventy others. He was sentenced to life in prison.",2012
2514,2012-05-30,Seattle,Washington,6,1,7,"Seattle cafe shooting spree: A patron who had been previously thrown out of the cafe, entered and killed four people and wounded one, shortly after he killed a woman during a carjacking and then committed suicide.",2012
2515,2012-04-02,Oakland,California,7,3,10,"Oikos University shooting: A former student opened fire in a classroom and fatally shot seven people, leaving three wounded.",2012
2516,2012-02-27,Chardon,Ohio,3,3,6,Chardon High School shooting: A seventeen-year-old entered Chardon High School and fired at students sitting in the cafeteria killing three and wounded three others before being arrested.,2012
2517,2011-12-16,Irwindale,California,3,2,5,"Southern California Edison shooting: An employee opened fire during the workday, and killed two and wounded two others before committing suicide.",2011
2518,2011-10-12,Seal Beach,California,8,1,9,Seal Beach shooting: A man entered his ex-wife's workplace and shot and killed eight people and injured one. He then fled the scene and was later arrested.,2011
2519,2011-09-06,Carson City,Nevada,5,7,12,"Carson City IHOP shooting: A man opened fire inside and outside an IHOP, and then targeted nearby local businesses. He killed four people and injured seven before committing suicide.",2011
2520,2011-08-07,Copley Township,Ohio,8,1,9,"2011 Copley Township shooting: A man killed seven people; including a 16-year-old and an 11-year-old, and injured one between three homes before being killed by responding police.",2011
2521,2011-07-07,Grand Rapids,Michigan,8,2,10,"Grand Rapids mass murder: A man killed seven people and wounded two in a spree shooting in two homes, then took hostages in a third before committing suicide.",2011
2522,2011-01-08,Tucson,Arizona,6,15,21,"Safeway Shooting in Casas Adobes, Arizona : A man killed six people and injured fifteen during an assassination attempt of U.S. Representative Gabrielle Giffords before he was tackled and arrested. Giffords was wounded in the attack but survived.",2011
2523,2009-11-20,Saipan,Northern Mariana Isls,5,9,14,"2009 Saipan shooting: A gunman shot at people throughout Saipan, before committing suicide at the edge of a cliff.",2009
2524,2009-11-05,Fort Hood,Texas,14,33,47,2009 Fort Hood shooting: A U.S. army psychiatrist opened fire and killed thirteen individuals and injured 33 others.,2009
2525,2009-08-04,Collier Township,Pennsylvania,4,9,13,"2009 Collier Township shooting: A man entered a woman's aerobics class and opened fire, killing three people and injuring nine before committing suicide.",2009
2526,2009-04-04,Pittsburgh,Pennsylvania,3,3,6,"2009 shooting of Pittsburgh police officers: A man opened fire on police officers responding to a domestic violence 9-1-1 call, killing three and injuring two before he was arrested.",2009
2527,2009-04-03,Binghamton,New York,14,4,18,"Binghamton shooting: A man shot and killed thirteen people at a civic center in Binghamton, New York before committing suicide.",2009
2528,2009-03-29,Carthage,North Carolina,8,3,11,"Carthage nursing home shooting: A man attacked the workplace of his estranged wife, killing eight people and wounding two others before being arrested.",2009
2529,2009-03-10,Geneva,Samson,11,6,17,Geneva County shootings: A man killed ten people and wounded six others in a shooting spree before committing suicide.,2009
2530,2008-12-24,Covina,California,10,3,13,Covina massacre: A man entered his former in-laws' home armed with four handguns and a homemade flamethrower. He killed nine people and injured three before committing suicide.,2008
2531,2008-09-02,Skagit County,Washington,6,2,8,2008 Skagit County shootings: A man killed six people and wounded two others in several locations before being arrested by police.,2008
2532,2008-02-14,DeKalb,Illinois,6,21,27,"Northern Illinois University shooting: A former graduate student entered a lecture hall and opened fire, killing five people and wounding twenty-one before committing suicide.",2008
2533,2008-02-07,Kirkwood,Missouri,7,1,8,"Kirkwood City Council shooting: A man opened fire during a public city council meeting, killing six people and injuring one other before being shot and killed by police.",2008
2534,2008-02-02,Tinley Park,Illinois,5,1,6,Lane Bryant shooting: Four customers and the clothing store manager were killed and a part-time employee was injured in a robbery gone awry.,2008
2535,2007-12-09,Arvada,Colorado Springs,5,5,10,"2007 Colorado YWAM and New Life shootings: A man stormed a dormitory at the Youth With A Mission organization in Arvada, Colorado before driving to Colorado Springs and attacking the New Life Church. He killed four people and wounded five others before committing suicide.",2007
2536,2007-12-05,Omaha,Nebraska,9,6,15,Westroads Mall shooting: A 19-year old killed eight people and wounded four in a Von Maur department store at the Westroads Mall before committing suicide.,2007
2537,2007-10-07,Crandon,Wisconsin,7,1,8,Crandon shooting: An off-duty sheriff's deputy entered a homecoming party at a duplex with a semiautomatic rifle and killed six people and wounded one. He killed himself later that day.,2007
2538,2007-04-16,Blacksburg,Virginia,33,17,50,"Virginia Tech shooting: A 23-year-old student killed thirty-two students and teachers, and wounded seventeen others. Other people were injured attempting to escape. When police stormed the building he was in, the shooter killed himself.",2007
2539,2007-02-12,Salt Lake City,Utah,6,4,10,Trolley Square shooting: A man opened fire in a parking garage and shopping mall and killed five people and injured four others before being killed by police.,2007
2540,2006-10-02,Bart Township,Lancaster County,6,5,11,"West Nickel Mines School shooting: A man took hostages in an Amish schoolhouse, and killed five schoolgirls and injured five others before committing suicide.",2006
2541,2006-07-28,Seattle,Washington,1,6,7,"Seattle Jewish Federation shooting: The perpetrator forced his way into the building, repeatedly shouting that he was angry at Israel and wanted to make a statement, he killed one and injured six.",2006
2542,2006-06-01,Indianapolis,Indiana,7,0,7,Hamilton Avenue murders: Two perpetrator killed a family of seven in a house at 560 North Hamilton Avenue.,2006
2543,2006-03-25,Seattle,Washington,7,2,9,"Capitol Hill massacre: A guest returned to a house party armed with a shotgun and a semiautomatic handgun. He shot indiscriminately, killing six people and injuring two, before committing suicide.",2006
2544,2006-01-30,Goleta,California,8,0,8,"Goleta postal facility shootings: A woman killed her neighbor before driving to the mail processing plant, where she shot and killed six people before committing suicide.",2006
2545,2005-11-20,Tacoma,Washington,0,6,6,Tacoma Mall shooting: A man attempted suicide by cop by opening fire in a shopping mall with an illegal MAK 90 semi-automatic rifle and a pistol. He injured six people and took four hostages before surrendering to a SWAT team.,2005
2546,2005-03-21,Red Lake,Minnesota,10,5,15,Red Lake shootings: A 16-year-old student killed nine people and wounded five others before committing suicide.,2005
2547,2005-03-12,Brookfield,Wisconsin,8,4,12,"Living Church of God shooting: A man shot and killed seven members of his church and wounded four others, before committing suicide in a Sheraton hotel.",2005
2548,2004-12-08,Columbus,Ohio,5,3,8,"Columbus nightclub shooting: A deranged fan killed four, including musician Dimebag Darrell, and wounded three others before being killed by police.",2004
2549,2004-11-21,Meteor,Wisconsin,6,2,8,Hunting Trip : A man shot eight people while on a hunting trip in northern Wisconsin; six were killed and two were wounded.,2004
2550,2004-03-12,Fresno,California,9,0,9,Wesson family murders: A man convicted of the molestation and murders of his children and nieces shot and killed nine members of his family during a standoff over a child custody dispute.,2004
2551,2003-07-08,Meridian,Mississippi,7,8,15,"Lockheed Martin shooting: A man opened fire at his workplace, killing six and wounding eight before committing suicide.",2003
2552,2003-06-14,Madison County,Montana,1,10,11,"2003 Ennis shooting: A man opened fire on a group of people outside of a bar, and then engaged in a high speed chase and shootout with law enforcement, he killed one and injured 10 including himself.",2003
2553,2003-04-14,New Orleans,Louisiana,1,3,4,John McDonogh High School shooting: Two perpetrators opened fire in the school gymnasium and killed one student and wounded three others.,2003
2554,2002-07-04,Los Angeles,California,3,5,8,"2002 Los Angeles International Airport shooting: The gunman opened fire at a line of passengers at a ticket counter, he killed two and injured five before being killed by a security officer.",2002
2555,2002-01-16,Grundy,Virginia,3,3,6,"Appalachian School of Law shooting: A former student opened fire after a meeting with a professor in the offices of the dean of students and a professor, killing them and a student and injured three other students before he was subdued by a Marine veteran.",2002
2556,2001-03-05,Santee,California,2,13,15,"Santana High School shooting: A 15-year-old student entered a boys bathroom and shot another student then left and began to fire widely, another student was killed and thirteen were injured.",2001
2557,2001-01-10,Nevada County,California,3,2,5,"2001 Nevada County shootings: The perpetrator opened fire with a semi-automatic pistol in two separate areas and killed three people and injured two others, before he returned home and confessed to the incidents via telephone to his brother, a Sacramento County Sheriff's Deputy.",2001
2558,2000-12-26,Wakefield,Massachusetts,7,0,7,"Wakefield massacre: Michael McDermott, an application support employee, shot and killed seven co-workers.",2000
2559,2000-05-24,New York City,New York,5,2,7,Wendy's massacre: Two robbers locked seven employees in the restaurant freezer and shot and killed five and wounded two during a robbery.,2000
2560,2000-04-28,Scott Township,Robinson Township,5,1,6,"Richard Baumhammers killing spree: A man went on a killing spree and murdered a Jewish woman before setting her house on fire and firing upon a synagogue vandalizing it with swastikas, killed an Indian man and injured a manager at a grocery store, shot up another synagogue, killed two at a Chinese restaurant, and an African-American exercising with his White American friend.",2000
2561,1999-11-02,Honolulu,Hawaii,7,0,7,"1999 Honolulu shootings: A service technician opened fire inside a Xerox building and killed seven people while an eighth escaped, he then held thirty-five school children inside the Hawaii Nature Center before surrendering to police.",1999
2562,1999-09-15,Fort Worth,Texas,8,7,15,"Wedgwood Baptist Church shooting: During a concert in the church for teenagers, the perpetrator entered and shot and killed seven attendees and wounded seven others before committing suicide.",1999
2563,1999-08-10,Los Angeles,California,1,5,6,"Los Angeles Jewish Community Center shooting: Affiliated with the Aryan Nations, the perpetrator killed one and wounded five when entering a Jewish community center.",1999
2564,1999-05-20,Conyers,Georgia,0,6,6,"Heritage High School shooting: A 15-year-old student opened fire and wounded six students before attempting suicide, he was stopped by an assistant principal.",1999
2565,1999-04-20,Columbine,Colorado,15,24,39,Columbine High School massacre: Two students from the school shot and killed twelve classmates and a teacher before committing suicide.,1999
2566,1998-07-05,Tacoma,Washington,5,5,10,"Trang Dai massacre: Four gunmen entered the Trang Dai Cafe and opened fire, killing five diners and wounding five others.",1998
2567,1998-05-21,Springfield,Oregon,4,25,29,Thurston High School shooting: An expelled student targeted his parents and the school and killed four people and injured twenty-five others before being arrested.,1998
2568,1998-04-24,Edinboro,Pennsylvania,1,4,5,"Parker Middle School dance shooting: A 14-year-old student opened fire and fatally shot a teacher and injured another and two students during an 8th grade dance, before being arrested.",1998
2569,1998-03-24,Craighead County,Arkansas,5,10,15,"Westside Middle School shooting: Two students aged 11 and 13, shot and killed four students and a teacher and injured ten others before being arrested.",1998
2570,1998-03-06,Newington,Connecticut,5,0,5,Connecticut Lottery Headquarters shooting: A disgruntled accountant employed by Connecticut's lottery headquarters shot and stabbed four of his supervisors before taking his own life by gunshot.,1998
2571,1997-12-01,West Paducah,Kentucky,3,5,8,"Heath High School shooting: A 14-year-old student opened fire on a group of students praying before the school opened, killing three and injuring five before surrendering.",1997
2572,1997-10-01,Pearl,Mississippi,3,7,10,"Pearl High School shooting: The perpetrator shot and killed his mother, then drove to the high school and shot and killed two students and injured seven before being arrested.",1997
2573,1997-09-15,Aiken,South Carolina,4,3,7,Aiken shooting: The perpetrator shot seven people at a manufacturing factory of his former employer. The perpetrator was executed in 2005.,1997
2574,1997-02-19,Bethel,Alaska,2,2,4,"Bethel Regional High School shooting: A student shot and killed two people and wounded two others before surrendering to police. He was reportedly assisted by several students in learning how to shoot, and many knew about the shooting plans in advance.",1997
2575,1996-02-02,Moses Lake,Washington,3,1,4,Frontier Middle School shooting: A student shot and killed a teacher and two students and wounded another before being arrested.,1996
2576,1994-11-07,Wickliffe,Ohio,1,3,4,Wickliffe Middle School shooting: A 37-year-old former student entered the building and shot and killed the custodian and wounded three other adults before he was arrested.,1994
2577,1994-06-20,Fairchild Air Force Base,Washington,5,22,27,Fairchild Air Force Base shooting: A former airman who had been discharged returned to the base hospital and killed four people and injured twenty-two people before being shot and killed by responding police.,1994
2578,1993-12-14,Aurora,Colorado,4,1,5,"Aurora, Colorado, Chuck E. Cheese shooting: The perpetrator shot and killed four employees and injured one in revenge for being fired from the restaurant.",1993
2579,1993-12-07,Garden City,New York,6,19,25,Long Island Rail Road shooting: A passenger opened fire on other passengers and killed six and wounded nineteen before being subdued by three passengers and arrested.,1993
2580,1993-07-01,San Francisco,California,9,6,15,101 California Street shooting: The perpetrator opened fire in an office building killed eight people and wounded six others before committing suicide.,1993
2581,1993-01-25,Langley,Virginia,2,3,5,CIA Headquarters shooting: A Pakistani national fired an AK-47 style weapon at a line of cars waiting at red light to turn into the main entrance of the CIA Headquarters. He was captured in 1997.,1993
2582,1993-01-08,Palatine,Illinois,7,0,7,Brown's Chicken Massacre: Two robbers entered a Brown's Chicken restaurant and murdered seven employees. The two were arrested and convicted in 2007 and 2009.,1993
2583,1992-12-14,Great Barrington,Massachusetts,2,4,6,"Bard College shooting: The perpetrator had been stockpiling ammunition and weapons in his dorm, and after several alarms had been raised by third parties, he opened fire and killed a professor and student and wounded four others.",1992
2584,1992-05-01,Olivehurst,California,4,10,14,"Lindhurst High School Shooting and Hostage Situation : A 20-year old past student opened fire on a classroom and killed four people, wounded ten others, and held eighty people hostage during an eight-hour siege before he surrendered.",1992
2585,1991-12-06,Austin,Texas,4,0,4,"1991 Austin Yogurt Shop murders: Four teenage girls aged; 13, 15, 17, and 17-years-old were shot and killed execution style after being stripped and bound with their own clothes, the store was also robbed and set on fire.",1991
2586,1991-11-01,Iowa City,Iowa,6,1,7,University of Iowa shooting: A former graduate student attended a meeting for a research group before opening fire and killied five individuals and injured one before committing suicide.,1991
2587,1991-10-16,Killeen,Texas,24,27,51,"Killeen, Texas, Luby's Restaurant shooting: A former Merchant Marine drove his vehicle through the front window of the restaurant before opening fire on a crowd of about eighty people, killing twenty-three and injuring twenty-seven before committing suicide.",1991
2588,1991-04-04,Sacramento County,California,6,14,20,"Sacramento Hostage Crisis: For eight hours forty-one people were held hostage inside an electronics store, by four Vietnamese refugees who killed three and injured 14. Three of the four perpetrators were shot and killed by responding police.",1991
2589,1990-02-10,Las Cruces,New Mexico,4,3,7,Las Cruces bowling alley massacre: Two unknown perpetrators entered the bowling alley and killed four people and injured three before fleeing. The case is still unsolved.,1990
2590,1989-09-14,Louisville,Kentucky,9,12,21,"Standard Gravure shooting : A 47-year-old pressman killed eight people and injured twelve at his former workplace, Standard Gravure, before committing suicide",1989
2591,1989-01-17,Stockton,California,6,32,38,Cleveland Elementary School shooting: A drifter used a semi-automatic rife to kill five children and wound thirty-two other students and teachers on the school playground before committing suicide.,1989
2592,1988-09-26,Greenwood,South Carolina,2,9,11,Oakland Elementary School shooting: The perpetrator shot and killed two eight-year-old students and wounded nine others  in the school's cafeteria and a classroom before being arrested. He was sentenced to death.,1988
2593,1988-07-17,Winston-Salem,North Carolina,4,6,10,"Old Salisbury Road shooting: The perpetrator shot nine passers-by from the center line on the road, killing four and injuring five before being arrested.",1988
2594,1988-05-20,Winnetka,Illinois,2,6,8,Attacks by Laurie Dann: The perpetrator entered the Hubbard Woods Elementary School and killed one student and wounded five others before entering a home and holding the inhabitants hostage before committing suicide.,1988
2595,1988-02-16,Sunnyvale,California,7,4,11,"ESL shooting: After stalking his coworker, the perpetrator entered the ESL building with several weapons and shot at employees and bystanders, killing seven people and wounding four before surrendering to police and SWAT officers.",1988
2596,1987-12-07,Cayucos,California,43,0,43,Pacific Southwest Airlines Flight 1771  The perpetrator David Burke entered the cockpit of Pacific Southwest Airlines Flight 1771 and killed the pilot and co-pilot as well as shooting three other people before crashing the plane and killing all forty-three passengers and crew on board.,1987
2597,1986-08-20,Edmond,Oklahoma,15,6,21,Edmond post office shooting: A part-time employee entered to begin his day before locking the doors and killing fourteen coworkers and injuring six others before committing suicide.,1986
2598,1985-10-30,Springfield,Pennsylvania,3,7,10,"Springfield Mall shooting: The perpetrator fired first at customers outside the Springfield Mall, and then moved inside and killed 3 and wounded 7 before she was disarmed.",1985
2599,1985-10-18,Detroit,Michigan,0,6,6,"Murray-Wright High School shooting: During half-time at a football game, the perpetrator opened fire with a shotgun on individuals that he had earlier fought with and wounded six.",1985
2600,1984-12-22,New York City,New York,0,4,4,1984 New York City subway shooting: Four teenagers were shot and wounded by the perpetrator on a New York subway train.,1984
2601,1984-07-18,San Diego,California,22,19,41,"San Ysidro McDonald's massacre: A male suspect entered a busy McDonald's and opened fire with an Uzi, shotgun and semiautomatic pistol, and killed twenty-one people and injured nineteen before being killed by a police sniper.",1984
2602,1984-04-15,New York City,New York,10,0,10,"Palm Sunday massacre: During a believed home invasion ten people—three adults, one teenager, and six children—were killed. An infant was left unharmed.",1984
2603,1984-02-24,Los Angeles,California,3,12,15,"49th Street Elementary School shooting: The perpetrator fired on children in a school playground from his home across the street, and killed two individuals and injured twelve others before committing suicide.",1984
2604,1983-02-19,Seattle,Washington,13,1,14,Wah Mee massacre: Three perpetrators entered a gambling club at the Louisa Hotel during a robbery and killed thirteen people and wounded one in an attempt to leave no witnesses.,1983
2605,1982-09-25,Wilkes-Barre,Pennsylvania  Jenkins Township,13,1,14,Murders by George Banks: The perpetrator used an AR-15 to shoot and kill thirteen people and injure one in his home and the home of a former girlfriend. A four-hour standoff occurred before officers were able to arrest and hold him on several charges.,1982
2606,1982-08-20,Miami,Florida,8,3,11,"Welding shop shooting: A teacher opened fire inside a welding shop, killing eight people and injuring three before attempting to flee by bicycle; he was run down as he cycled away.",1982
2607,1982-05-03,Anchorage,Alaska,4,0,4,Russian Jack Springs Park shooting: A schizophrenic man left a psychiatric hospital on a day pass and killed four teenagers in a park before being arrested.,1982
2608,1981-05-07,Salem,Oregon,5,18,23,"Oregon Museum Tavern shooting: The perpetrator entered the location and fired, killing five people and injuring eighteen before he was wrestled to the ground.",1981
2610,1980-06-22,Daingerfield,Texas,5,11,16,Daingerfield church shooting: The perpetrator killed five people and wounded ten others after they had declined to be character witnesses in the trial of him raping his daughter.,1980
2611,1979-11-03,Greensboro,North Carolina,5,12,17,"Greensboro Massacre : Members of the Communist Workers Party and others demonstrated against the KKK and the American Nazi Party, the event dissolved into a gunfight in which five people were killed and about twelve people were wounded.",1979
2612,1979-01-29,San Diego,California,2,9,11,Cleveland Elementary School shooting: A 16-year-old girl who lived across the street shot and killed two people and injured nine others before being arrested.,1979
2613,1978-06-28,Boston,Massachusetts,5,0,5,Blackfriars massacre: Four known criminals and a former Boston television investigative news anchorman and reporter were all killed in a supposed sale of cocaine.,1978
2614,1977-09-04,San Francisco,California,5,11,16,"Golden Dragon Massacre : Five members of a Chinese youth gang attempted to kill rival gang members, which quickly turned into a shootout in which five people died and eleven were injured.",1977
2615,1976-07-12,Fullerton,California,7,2,9,"California State University, Fullerton, shooting: A custodian at the university killed seven people and wounded two others before fleeing the school. He was arrested.",1976
2616,1975-03-30,Hamilton,Ohio,11,0,11,"Easter Sunday Massacre: The perpetrator shot and killed his mother, brother, sister-in-law, and eight nieces and nephews in five minutes before calling police and being arrested.",1975
2617,1974-12-30,Olean,New York,3,11,14,"Olean High School shooting: A student locked himself in a third floor room before shooting out the window, killing three people and injuring eleven before being subdued with tear gas and arrested.",1974
2618,1974-11-14,Amityville,New York,6,0,6,"Ronald DeFeo Jr. Family Murders : Basis for The Amityville Horror, where the perpetrator was convicted for the killing of his parents and siblings, six people in all.",1974
2619,1974-10-19,New Britain,Connecticut,6,0,6,"Donna Lee Bakery murders: A bakery owner, a clerk, three customers, and a passerby were shot in the back of the head during a robbery at a bakery.",1974
2620,1974-04-22,Ogden,Utah,3,2,5,"Hi-Fi murders: Three men robbed a Hi-Fi store in Ogden, Utah and took five people hostage by tying them up and torturing them, then shooting three of them to death and injuring two more.",1974
2621,1973-11-17,Lyon County,Iowa,4,1,5,"1973 Gitchie Manitou Murders: Five teenagers were attacked in Gitchie Manitou State Preserve, by three brothers. The four males were killed and the female was kidnapped and raped before escaping.",1973
2623,1972-09-06,Saint Croix,United States Virgin Isls,8,8,16,"Fountain Valley massacre: Five men shot at employees and tourists at a golf course, killing eight.",1972
2624,1971-11-09,Westfield,New Jersey,5,0,5,"Murders by John List: John List shot and killed his wife, mother and three teenage children in a belief that he needed to save their souls through death, he was arrested in 1989 after living under an assumed name after a neighbor recognized him from America's Most Wanted.",1971
2625,1971-02-15,Dallas,Texas,3,1,4,"1971 Shooting of Dallas Police Officers: Two men abducted five law enforcement officers, before opening fire and killed three and injured one. The fifth officer escaped and called for help.",1971
2626,1970-08-07,San Rafael,California,4,2,6,"Marin County Civic Center attacks: The 17-year-old perpetrator took hostages in a court room in an attempt to coerce the release of the Soledad Brothers. Three prisoners released during the siege joined him in the attack, which left the main perpetrator dead along with three others and two others wounded.",1970
2627,1970-05-15,Jackson,Mississippi,2,12,14,"Jackson State University shooting: After responding to the university due to a growing unrest, officers opened fire on a dorm building and two students  were killed and twelve were injured.",1970
2628,1970-05-04,Kent,Ohio,4,9,13,"Kent State shootings: During a protest of the bombing of Cambodia at the university, members of the Ohio National Guard opened fire, killing four and injuring nine people.",1970
2629,1968-06-25,Good Hart,Michigan,6,0,6,"Robison family murders: While vacationing, a family was shot and killed, with the parents also bludgeoned with a hammer. The investigation continued for fifteen months after the bodies were discovered.",1968
2630,1968-02-08,Orangeburg,South Carolina,3,27,30,"South Carolina State University shooting: After responding to the scene of about 200 protestors protesting racial segregation, after an officer was assaulted, officers began to shoot into the crowd; three people were killed and twenty-seven injured.",1968
2631,1966-11-12,Mesa,Arizona,5,2,7,"Rose-Mar College of Beauty shooting: A gunman inspired by other mass murderers held seven women at gunpoint at a cosmetology college, including two babies, before fatally shooting five of them and wounding two.",1966
2632,1966-08-01,Austin,Texas,17,31,48,"University of Texas tower shooting: A student and former Marine sharpshooter killed his wife and mother before using the University of Texas clock tower as a sniper's nest to kill 15 people, including a pregnant woman, and wound 31 before being killed by police.",1966
2633,1965-04-25,Orcutt,California,4,10,14,"1965 Highway 101 sniper attack: A 16-year-old stole his father's military rifle and shot at automobiles driving down the highway, killing two and injuring eleven before committing suicide. A third victim died later at the hospital.",1965
2634,1959-12-19,Osprey,Florida,4,0,4,Walker Family Murders: A husband and wife were murdered along with their two children after returning home. The wife was also raped prior to being killed.,1959
2635,1959-11-15,Holcomb,Kansas,4,0,4,"Clutter Family Murders: Four members of the Clutter family, parents and two teenage children were shot and killed in their home by two robbers.",1959
2636,1958-01-18,Maxton,North Carolina,0,4,4,"Battle of Hayes Pond: During a publicized Ku Klux Klan rally there was a clash between Lumbee Indians and Klan members, causing a disruption of the rally and four Klansmen to be wounded. Most of the resulting news coverage condemned the Klansmen and praised the Lumbees.",1958
2638,1949-09-06,Camden,New Jersey,13,3,16,"'Walk of Death' Killings by Howard Unruh: The perpetrator walked through his neighborhood for 12 minutes and killed thirteen; including three children, and injured three.",1949
2639,1946-07-25,Walton County,Georgia,4,0,4,Moore's Ford Lynching: Four young African Americans composed of two married couples were lynched by a white mob and were shot and killed.,1946
2640,1945-07-08,Salina,Utah,9,19,28,Utah Prisoner of War Massacre: Nine German POWs were killed and nineteen wounded by an American Army Private who shot at them while on guard duty.,1945
2641,1935-10-24,Rio Piedras,Puerto Rico,5,2,7,Rio Piedras Massacre: During a student assembly armed guards had been requested in case of violence. After stopping a suspicious vehicle a struggle ensued and four members of the Puerto Rican National party were killed as well as a bystander and a student and officer wounded.,1935
2642,1933-06-17,Kansas City,Missouri,5,3,8,"Kansas City Massacre: Four law enforcement officers and a fugitive were killed, with three law enforcement officers wounded in a shootout between the two groups.",1933
2643,1929-12-25,Germanton,North Carolina,7,0,7,"Murder of the Lawson family: Charles Lawson shot and killed his wife and five children, and bludgeoned his youngest child to death, before committing suicide. The second eldest child survived after being sent on an errand.",1929
2644,1929-02-14,Chicago,Illinois,7,0,7,Saint Valentine's Day Massacre: Seven members and associates of Chicago's North Side Gang were shot and killed execution style against a garage wall.,1929
2645,1927-11-21,Serene,Colorado,6,0,6,"Columbine Mine Massacre: A fight broke out between striking coal mine workers and Colorado state militia. The unarmed miners claimed that they were fired upon by a mine tipple or machine gun, which is disputed by police.",1927
2646,1924-09-09,Hanapepe,Hawaii,20,0,20,"Hanapepe Massacre: During a strike of Filipino sugar workers, in an attempt to rescue two hostage strikebreakers police killed 16 strikers, while strikers killed four law enforcement members.",1924
